中国移动营销行来发展报告alink	王大姐，打字细心一点
小马也疯狂------地位之争。	于老师不给劝劝架么告诉他们再挣也不是老大
那些年，我们一起偷看过的电视。「暴走漫画」	真不愧是这么走出来的爹·······
北京的小纯洁们，周日见。#硬汉摆拍清纯照#	嗷嗷大湿的左手在干嘛，看着小纯洁撸么。
要是这一年哭泣的理由不再是难过而是感动会多么好	我已经快感动得哭了。
对于国内动漫画作者引用工笔素材的一些个人意见。	(ﾉ´∀｀*)ﾉ大师说的好！各种长知识了
猫咪保镖最赞了！你们看懂了吗？！（来自：9gag）	喵喵保镖抢镜了哟。
莫愁和所有人开了一个玩笑——其实，她是会正常唱歌的……	说是会咳嗽就会唱歌。她的问题是一咳嗽猫都跑。
你见过皮卡丘喝水的样子吗？	小日本的东西再好都烦
如果有个人能让你忘掉过去，那TA很可能就是你的未来。	····关键是那人是否忘记他的过去。
我在北京，24岁，想去马尔代夫，一个人。	我在太原，24岁，想去捷克，两个人。
哥你还跳不跳楼了？我们要下班啊！	我想说很多这样的人其实不是想跳楼的。
龙生龙，凤生凤，是个喵咪它就萌。	微信都加了，说好的8.20呢！
从胚胎期开始的面部特征演变过程	自然生理变化中的面部演化过程
本届轮值主席王石致开幕词。讲60岁上哈佛。	任总，再有这机会带我去呗
非常不喜欢北京现在的天气……非常……	我也不喜欢那种又冷又下雨的天气了！
我第一次坐飞机是进安达信的入职培训，在深圳。你们哪？	去帝都游乐园玩。那时候20块进去随便玩
人生如戏，全靠演技。小受吓坏了。	人生如戏，全靠演技。
为什么这世上会有人以刁难他人为乐呢？	因为他们没钱买可乐
算了算了，我看出来了，你们都想看男人！上张美男图。	多放点男模的照片看看
偷拍时被喵星人发现了。！\3/	二饼你好！JOKER你好！
看看你的名字在古代是什么职业，太让人崩溃了。	蜀汉黑心侠客。我喜欢。
居然把WindowsPhone8写成Win8了……要严谨啊	老魏今晚视频不见不散呐
百合真香啊！送给回家路上的人们明天后天就不行了！	浇点啤酒养着，就能开久一些，试试看
刘翔预算摔倒！无缘半决赛！主持人哭了。	惨，意料之中，可惜，努力了就好。
谁身边没几个能办大事的朋友？	1个亿把天安门照片换成我爹，然后发现自己名字被改成毛岸英
一位妈妈将她四岁儿子的涂鸦做成了真实的毛绒玩具	太厉害了！小朋友是最好的设计师，妈妈是最有爱的制作人。
竟然下雪了，不喜欢冬天，天气何时才变暖啊。	记得雪莱的诗句吗？＂冬天来了，春天还会远吗？＂
困扰我多年的问题终于得解了。	鱿鱼墨鱼笔管八带还有啥？
大学生一定要看的一分钟，它能让你奋斗一辈子alink	我喜欢；水能复舟。也能。
#米吧秀图#月底了，敢说出你手机还有多少流量么？	这个图片是谁照的啊，真是绝啊
我擦！这么多人来看我！	咔咔，愚蠢的人类。【严肃脸。内心独白】
各位都到了吗？深圳一会见哈：））	在深圳哪里呀？办节目吗？
如果有人煮这个汤给你喝，你会感动吗？	把胡萝卜拿出来丢掉，继续喝汤。
上传了23张照片到“微相册”。alink	好漂亮。希望能揭开所有谜底。
看见有黑点的要注意休息了。	放远点看就没有啦。近处看一堆的
若慈善不透明，则捐款无意义。	慈善再透明，捐款都无意
成熟的最大好处是：以前得不到的，现在不想要了。	姐姐走出来了，可喜可贺。
编织和仿旧的风格，看起来很有质感	从配色到用料都是喜欢的类型。
听到这周要连上7天的消息后，我突然意识到。	放假一天的看到这句表示压力零了。
慢镜头回放狗狗看到食物的可爱反应！alink	1:12秒内个很销魂啊。
个人经验，普通话过于标准的人一般干不了什么大事。	可以做主持人，播音员，央视的那些也算是干大事吧
喵星人个个都是武林高手！	都说喵是会飞的真不开玩笑
2012地球不会毁灭，因为多啦A梦告诉我们他是从2070年来的。	不毁灭啦？那我惨咯。
#虎扑话题#谁是你心中外貌最帅气的教练？alink	里皮一出，谁与争锋？
苹果不要只削一半好不好！你们考虑过苹果的感受嘛！	还好，留了一半皮。要不早就被消灭了。
转眼，他走了16年。如果，他还活着……	这样的话我们都可以问，唯独你不能问！
alink讲好公子和坏公子的文章，不错。凤凰网。	作吧，总有一天报应，大家稍安静候。
杨怡真的好像马啊！好想喂她吃草！	给跪了，真是伸手不见五指！
【治愈系图片】又到了毕业季——这么有爱的毕业照你们见过吗？	我就像里面珂南君，你呢
科普贴：《大林和小林》剧照	看着好吓人啊！有没有人同感？
另外一个坏消息，巴恩斯续约快船，孩子们，咱又没戏了。	相信湖人，相信24（楼下的整理好队形'给主页希望）
过去我们再也回不去了，	外国人的创意总是让我有惊喜。
一群垃圾的制造者，当然也包括我自己。	应该是一群资源的遗弃者
走近科学：神农架野香蕉。国外又称死人手指	能吃吗…………好想吐……
不要恋家！又要开始训练啦！不想回家，一点也不想	加油吧！我们支持你。
#郑在提醒吃早餐#没忘了吃早饭吧？餐桌上这段文字出自哪部作品？	大叔的早餐好有营养！
男子因女儿哭闹一脚将其踢死alink	小孩哭闹的确很烦人只能说这位父亲点背给踢死了
当你觉得生活没意思的时候。(转)	当你觉得生活没意思的时候。
百度官方微博即将上线，敬请期待！	中国搜索引擎的大佬也来微博了。
长春柏翠园小区绿化植物之一：伞形紫花，灌木，科属种？	怎样能和您有合作机会呢
#NBA总决赛#热火击败马刺，卫冕成功。	老兵永远不死。虐心的第六场！
据说，强迫症的童鞋看完之后很难受。「转」	强烈鄙视，哪有这样折腾的，你们考虑过耳塞的感受吗？
谁是谁的如花美眷，谁错过了谁的似水流年。	句子很矫情，图片很诡异。
人的眼睛有5.76亿像素但却终究看不懂人心。「转」	这个化功我是佩服了！
好像反动派们都不在这里？	你就是“反动派”。罗！
农夫山泉右边是假的，大家转发告诉身边的朋友。	早被农夫山泉辟谣了，两个都是真的。
不去刻意造作自己的心自然自在随性而天真	顺其自然，随遇而安，一切随兴，能不能
巴萨官方宣布阿根廷人马蒂诺出任球队新帅！	我去。我也一直以为是恩里克呢。
多关注新电影＜致命闪玩＞💓💓	里面有露点吗？有就看.
三峡大坝质量如何？诡异。分享图片	知道什么叫一年不如一年了。
老师改到这份答题卡的时候，跳起来了。	哈哈。玩这个玩疯了吧。
世上最幸福的事：坏脾气的她遇到好脾气的他，他却爱上了她。	这相爱好奇怪，无法理解。
据说，这是布拉德皮特写给妻子的信——《爱的秘密》。	女人是男人的镜子，你怎样对她，在她身上全部展现无遗。
在飞往尼泊尔的机程一口气看完。	我才看了5页。就没接下去看了。
据说是二年级的数学题你会吗？「转」	变态的教育，是想培养出来孩子变态的思维能力吗
法网女单决赛李娜VS斯齐亚沃尼CCTV5视频直播：alink	李娜VS吕颂贤好吗，哈哈哈哈
乞丐虽穷但有人格，猪狗不如畜生是也！	这又是那个狗娘养的，骂已出口，对不起这位畜生的母亲了。
各种失误，你们感受一下。	厨房那个太搞笑了！哈哈哈
吃泡面的最高境界！你有木有！	啃爹啊，汤都喝光的吗？
诺基亚Lumia710组成的多米诺，想不想推倒TA？	想推倒TA，再送我三个颜色的就够了！
请各位朋友不要把我列入自媒体.谢谢.	从您这学习很多。最棒的自媒体！哈哈哈哈哈啊啊
叶秉桓刚刚示范了一下「转音转到吐」。声线挺棒。	强烈恳请中国好声音与我是歌手合并为中国歌手〜
童鞋们，咱们一起过六一喽😁😁😁	儿童节快乐！我要礼物…
好怀恋的宿舍生活，有同感的转吧！（via陈骏基）	怀念死了！想哭，抱抱大家，快来抱抱我，呜呜。
据央视刚刚报道，神八飞船发射时间确定为今日5时58分10秒。	神八威武，坐等发射
欠自己的旅行，有一天，一定要还给自己！	一定还给自己一次快乐的旅行
有多少人，还记得当年学校的校训的，请举手！	英华女校：寸阴是惜
打车经过伦敦塔，皇室的监禁地和处死地。#Weico拼图#	是威斯敏斯特宫吧，好像也就是西敏寺
哎呀不关我事。是系统自动发送的……我是小倩alink	><求视屏小图看不够过瘾.
别以为我脸大，就可以随便捏我脸！	听见没，不要捏我！
很开心跟你们聊天，晚安	你是睿智的成熟女人。爱你。晚安
记住每一个善待你的人，因为他们本可以不这么做。	感谢每一个对你好的人，因为他们本可以不用对你好的。
仙剑小说2卖得不错，这是京东的排行榜，销售排行榜第一。	先道一声恭喜！不过确实不错！
为了iPhone打字大赛，我的手做了个小手术。	一直觉得这图恶心。
一定要买这张CD，#李霄云#的《你看到的我是蓝色的》	介个要买专辑的事可以当真的吧，哈哈
好声音，一在室外唱现场，怎么就那么大差距啊。	就跟你们一打国际大赛就被各种虐一个道理！
未来十天在波兰，手机不通，有事麻烦私信或邮件吧。	转眼两年前我也在波兰
我这种壮汉，一穿细高跟鞋，就好像在欺凌强暴它。	还会担心把跟踩断。
他们也曾是冠军，但。请看图（转）	信什么也别信dang和zf
北京下雪啦已经不记得上次堆雪人是哪一年	北京下雪难道不是很平常的么。
听我老婆说你咬过她。你别跑！站住！alink	表示看到ANGEL的菊花==
麻麻门在哪里啊，瓦们要出门啦。（欢迎童鞋们添加画外音）	我想要大房子，我们住得有点儿挤
【做个专业的好主人】看懂狗狗的语言，这是多么有必要啊！	好卡哇伊。看懂了这些，你是否也想养只狗狗
家里有个鱼塘感觉就是好！	不好不好，有小朋友的家里千万不要有这样的鱼塘，，，，危险
分享图片普陀一日游呵呵！	为了冠军去新疆吧，为了提高收入去新疆吧，珍爱生命，远离南钢！
汉字太厉害了，看了好久，我承认我中枪了。	啊。华丽丽的中枪了！我读的超顺。完全没有发现！
如果柯南结局是这样，你能接受吗？（via人人网苏暖心）	就算大家希望这样青山刚昌也不会这样的
你们年轻人不知道这个吧，只有我们老一辈的才深有感触。	现在也有啊，每天晚上过了12点，某些电视台都有这个画面
宇宙地镇很黑村，内蒙古看到一个霸气的村镇，牛逼啊。by猫扑	内蒙格敢不敢不这么霸气
炖小母鸡，配料还缺什么吗？可惜姜不够老。	看的我都馋了，可以闻到香味儿呢。
如果感冒再不好我就……	苗姐你身体好我心情就好！
电要用得聪明，这个广告本身就说明了这点。	创意原本该如此简单(分享自Weico频道alink)
贾正经你在我床上做什么坏事呀。	肯定是尿尿了，没好意思告诉你，哈哈
最疼我的男人我真的很爱你。（via小凤凤的小图图）	最爱我的男人，我也爱你
赶路，司机给我补课，给我听吴莫愁的歌。	吴莫愁，我欣赏她，敢于发泄灵魂。
火车站和长途汽车站才是当今中国，飞机场不算。	同意，总是喜欢外表奢华内脏糜烂
看到最后的文字，终于懂了！	现在社会现象就是异地恋电话XXOO维护感情
#UC9语录#不要害怕批评的声音，因为那是对你最好的鞭策。	iPhone手机，最新的版本在哪登陆账户信息
告诉你！哥抱的不是美女，是旺财！	我比较关心的是这只狗狗的性什么···
世界银行行长已面临非常严峻的失业危机	真实真的还是煮的？
兰州牛肉面的江湖风云榜（Via:茉莉Sunmoly）	我不行了'''我的Forever二细
与NBA球员比手大！猜猜哪只手是我的？	胡说，那只大的才是啊雅的，小的是MBA的
小时候吃过这朵花的请举手！	这吃法原来已传遍大江南北了。
某人已经彻底废了，她的新歌以后不听了	去年今年差别太大，莫非去年真是假唱？
马刺啊马刺，煮熟了的鸭子抖抖热水居然又飞走了。咋这样呢？！	是啊，哎，这个搞得人心情不爽啊
绝望了！对这个卖萌的世界绝望了！	兔斯基也撑不住了。
这位女生从小看郑渊洁的书。现在她已经读博士了。（助理代发）	那么。郑渊洁也老了。
#每日趣图#这炫技的停车，太拉风了！	哪里没人，不是有个穿白衣服的人吗
复古-惊艳！真心太美了！	哇，好美，我以后会穿上这么美的婚纱么？
有时候你必须跳出窗外，然后在坠落的过程中长出翅膀。	是这样的。需要一定勇气跳出窗户
昨晚动车上没睡好。明早早班飞上海。今晚要早睡了。	任总，保重身体！说实话的人在中国太少了！
这个抱枕实在太逗了。	它坐在这里，晚上会出人命的。
那些年我们传过的谣言	政府会说：大家去看大片《2012》，政府懵老百姓这是国际惯例。
童鞋们，offer到了！（图by英文王子_张介英）	#新年#作为申请留学的孩纸，我不转这条都对不住我自己！
微小弱势草根群体挣扎着搏一搏就叫微搏。	同时，还有很多有良知的群体加入，形成了一股正义的微博力量！
将来你会感激曾经努力的自己。（via：Hamicat哈咪猫）	将来的你会感激曾经努力的自己！
朋友们早上好，今天的空气质量。	泥马，睡不着，背书去
【童年记忆】为这个东西开心半天的小朋友。现在都不小了吧？	哇，麦丽素，好爱哦、、、
发表了博文《周末画报-孙俪》-alink	抽什么烟抽烟也能上封面？
星巴克月饼！想吃的举手！	每家都有？一看就是我喜欢的口感
上两天班就休息了，交响乐演绎《西游记》alink	80后的十大人物，果然名不虚传。
我很喜欢这个故事，我要特別谢谢送给我这本书的人。	格字后面那个什么字？
网友对""哈利波特""的相貌预测。	杀猪刀啊杀猪刀…太残酷了…
当杨过穿上金轮法王的衣服后：杨过+金轮法王=项少龙	完全否定了人靠衣装这个说法···
麦霸升级全纪录……你到哪一级了？（via：夏Dora）	我已经突破天际了。
#云中歌#我造型美么我点评了alink	美得不明显。来自话题#云中歌#alink
童年的快乐，是如此的简单！	全是回忆不得不转！
共产主义大桥：封闭施工，禁止通行。	修理费太贵，还是另造合算！
#NBA精彩GIF#夏季联赛，火箭队特伦斯-琼斯欧洲步扣篮。	还是wade的好看，更劲爆
女侠我看你骨格精奇……	…………………………………我想我是找到好东西了
拍戏好辛苦啊我要回家555555。	犹抱琵琶者，徐静蕾？
你只适合思念，不适合见面。	和最爱的人相濡以沫，和次爱的人相忘于江湖
周二在西湖边拍摄的花儿一朵，大家早安。！	哇塞这是真的吗好漂亮感觉像假的花
今儿怎么没有失眠签到呢？喂神马？	原本想睡，翻开天竺智障大师的微博，笑多了睡不着了…
【快讯】央视报道，韩国“罗老”号运载火箭发射取消。	屡战屡败屡败屡战…………
首盘黑棋，北京时间今晚十点开战：）hoId住！	小棋后。魏晨哥哥给你加油咯。必胜！
我敢保证这是全世界最假的广告！没有之一啊alink	太假了给红包和没给红包时的表情调转了
累了吗？来，givemefive。给你一点正能量！（图转）	hey，highfive！(⊙o⊙)
『北京晨报』老贝将娶女儿闺密alink	希望他们能真正得到快乐
放长线，钓大鱼，水里的玩意上岸了……	果然没有免费的午餐啊。
今天婚礼我们一定会幸福的	好美的新娘，你们一定会幸福的！
春运上车前。到站下车后。	乐出音了，旁边人直看我
还有没睡的吗？忙什么呢？	刚刚上线，品牌定位比较高，在头痛怎么推广，货存压力也大
龙女EmiliaClarke在《权力的游戏》第三季首映式！	是不是真的。我的女神这戏里戏外差距也忒大了。
这是传说中的“滚回你的火星去”吗？	这只应该是松鼠吧，在外国算不算是虐待动物呢？
春节了，让爱回家。alink	马上过节了对老爸说句“我爱你”！
长颈鹿同学悲催的一生。（via5千克）	神啊，赐我个粉丝吧。
和老妈一起吃午饭。一会儿去上海农场。	老太太精神真好，祝身体健康。
铁丝的影子艺术！你喜欢吗？	总会有一个人。始终追随着你的影子
看一次笑一次。被自己钓的鱼吓坏了的小朋友。	哈哈这个真心好笑。学习累了就上来看看吖吖。
穿行花千树，车若舞龙，人欲疯。	这个风不是一般的大啊
卖烤肉串的，老有才了！	少了个新浪微博呀！
赖昌星无期，吴英死缓，薄谷开来死缓，夏俊峰死刑复核中。	有名了，官当大了，想死都难，表同情
有时候，这就是人生……	呵呵，往前一步，或退后一步，都有不同的境遇
如果你突然被告白了，你会是下面哪种反应？（转）	好喜欢最后一个那种！
该微博已删，大家看到了吗？	看到了，一群猪在法院上班
大喜大悲看清自己，大起大落看清朋友。	下面在做，上面在看
【8月2日17时头条新闻要闻回顾】alink	城管参战？笑话！枪口只会对准自己的老百姓吧
32岁女志愿者汪策在芦山县境内被坠石砸中遇难。	心里难过的同时，还是希望留有通道给更专业的救援队先进去吧
所谓人生，便是取决于遇见谁。	缘分终究会到只不过早晚的事
天赐真的饿了。第五天就要过去了，加油啊！	好心疼啊。宝贝儿，多吃点，好好休息。
颇为靠谱的iPhone5保护壳曝光，10月4日前，给你无尽的想像！	这个机身设计我喜欢
这就是传说中的包子脸嘛=.=吃货太萌了	哇哈哈哈。南瓜头，南瓜脸
我发觉最喜欢土大款式奢华的不是土大款，是领导	其实两者差不多，都没什么品位
DC与漫威如果掐起来了，口胶侠与鹰眼一定要互射。	正义联盟与复仇者联盟
求人肉！天津和上海的人们能忍么！	北京下雨怎么没淹死她呢？
再见，欧洲杯！荷兰，再见！	没事，这就是荷兰，换个主帅，2014再看郁金香绽放。
四川！雅安！川人不倒！同胞雄起！	谢谢，谢谢！赵普老师关心和祝福！雅安震区救援正在进行中……
【漂亮的纸桃心】巧手一双！好美！	真美，留起来美化教室可以用到。
前原诚司：中国是“一贯伪造自己历史的国家”alink	日本也是啊，包括南北朝鲜，亚洲人大多这样
就冲着郭敬明抄袭也死不悔改那劲儿我还就人身攻击了	他心眼和身高可成正比了呢
密切关注草榴有无最新种子流出。	po主想跟小秘书小姐发生不正当关系了吧
母亲节，告诉妈妈，我爱你	好有爱！。愿全天下的母亲永远快乐！
雍正行书---“月影通帘细，花香入座清”	雍容，但不锋芒，喜欢。
#NBA酷图#那时候，我还在小牛；那时候，你还是8号。	如今都成家立业了都老了
#品一品#爱，不是改变对方，而是一起成长。	爱不是改变对方，而是一起成长
这哥们几乎没有不会的项目，人类已经无法阻止普京了。	论个人魅力，普京是现任各国首相中魅力值最高的
真话和假话，究竟哪个更吃香？	生于忧患，死于安乐。
这年头，不发个新版本都不好意思跟大家说圣诞快乐！	更新了什么内容啊，透露透露
志军为朋友两肋插刀，护主有功，被赏缓刑。	两年之后，大家淡忘之后又是好汉。
在雪中，在一个洁白、干净的世界中。	安静，比什么都好。别把自己弄的那么烦。
无论你多么讨厌你的学校，当你离开久了，你还是会想念它。	想念那时年轻的我们
当代文学史上最珍贵难得的一幕	莫言的帽子真好看。
谁敢跟他们比无聊！「图转」	最后一张是。腿毛？
《致青春》好无聊，勿喷。	看到罩疣婷，直接软一半
悍马H2变马车。吃饱了撑着才这么玩吧！	我想问这马拉得动吗
喝醉了才知道你最爱谁，生病了才知道谁最爱你。	每次喝酒后最想的一个人都是她！
大功告成，六斤四两小公主正式release。ld辛苦了	虽然不认识，不过还是祝福下。
用烤面包铺出来的烤面包机。	这么浪费。就不怕引来几百只蟑螂和老鼠啊。
赖床是对周末最起码的尊重。	原谅上课的我不能再尊重你了周末！
所以说，印度成为世界第一强国是迟早的事	不是已经是世界第一强国了吗！？第一强奸大国
【《性生活在别处》作者：暖小团】alink	好文共欣赏。哥问：你最牛逼的性生活在何处？
那些年追过的东方神起。喜欢的，举手哦！(转)	对我来说是：这些年追过的朴有天
有人活着为了活着，有人活着那叫生活。	有人活着只是因为未来还伴有希望
埃及政府拒绝军方48小时最后期限alink	穆兄会也坐不稳啊，看来还是枪杠子了出政权。
这是我一生中离胡哥最近的时刻，3公里	福田区居民表示还是很远啊。
2012北京车展你错过这个了么？alink	我丫根就错过车展了，全是那些不走的大二占了我的名额。
在浏览器输入“alink骗吃骗喝骗炮打.com”这个网址试试看！	介于牛A与牛C之间+10086
一路走下去，没有行李没有牵绊没有束缚，就那么简单	一万多粉丝都没嫁出去啊。
见过这么大的寿司吗？真是太给力了，想吃么？	这个太假了吧，米不可能有这么大的！
听他们说这图上没有女人，我看完自觉面壁了。	仔细看了还是个女人啊
据说，你梦到了一个人，是因为那个人在想你。	好像不对吧…我梦到的人不应该想我呀…
这个年头不抽烟的人真难找，不抽的请转发！	讨厌烟味！绝不抽
果然纳沙台风风眼比整个海南岛大！海南！要hold啊！	在海南的兄弟姐妹们要小心啦
＂如果我们停下来，我们什么都没了。＂	＂如果我们停下来，我们什么都没了。＂晚安
我准备「闭目养神」几日。	难得休闲，不可放过！
小桥流水般的洗手池，太喜欢了！	感觉不错··但是那放毛巾的架子···
她们都说我现在变的很成熟，而我只是比以前变的自私了而已。	谁比谁自私，谁比谁成熟
听说北京下雪了，对吗？	不是吧，都下雪了？成都今天只是感觉到下降了5-6°呢
1992年的我。对不起，请叫我——“铁道部刘德华”。	还真有点神似，敢问董老师后来如何长劣巴的？
好朋友设计的首饰，穿最简单的衣服最好配！好喜欢！	喜欢静姐身上黑色毛衣，可以告诉我撒牌子？求回复！
沉默，可以让混乱的心，变得清澈。	沉默，可以让混乱的心，变得清澈
老爵爷，向您致敬！没有您，就没有曼联！	谢谢老爵爷，谢谢曼联，20冠
美丽镜头下的那份宁静，让你彻底爱上这里——西塘	去过，人少的时候很美
樱桃小丸子长大了……哎！人生得一丸子，足矣。（图转）	博主，还我童年回忆
据说这是女士们风险低、回报率最高的一种投资方式！（转）	月薪还是年薪？日元还是英镑？
大S和富二代结婚之后就变成了大$	大S和富二代结婚之后就变成了大$。
「请便后冲便以便后便者再便」，求下联。	求种后留种发种让种者再种
化妆ing，一会儿录影开始，18期，加油…	噗，你故意的吧。Auv，这楠楠姐叫的噢。
#S+#这个点大家都在看#中国好声音#？	我想看来着，但是在逛超市呢
★世界上10家最美的书店。	等我去了，三个月不愿出来！
男团半决赛两个功臣	娃姐给做啥好吃的啦，给乐乐乐成这样
“诺不轻信，故人不负我，诺不轻许，故我不负人。”	诺不轻许，故我不负人。
长颈鹿长颈鹿。乃滴脖纸为什么介么长。	小胖我真是一天比一天更爱你
剧情超乎想像，好莱坞弱爆了！	你给了网民20分钟制造谣言的时间
老实说，还是咱八十年代的星靠谱有范。看费翔，那风度	费翔是我记住的第一个明星。
这货不是情人儿，这货是姐妹儿。💋	头像和我微信一样！
一但生气，一但情绪，人就变笨了。	我现在就是最聪明滴时候了。
建议：今晚北京可以提供援助的车辆，都打开双闪，便于识别。	没车的眨麻眼算吗？
遇到这种傻逼我只能这么回他！	小互，滚字后面一般都应该加个回字。
暴强的公路减速带，比交警还管用。	咱抚顺不用。满大街都是刨的坑。全年可畅游哦。
Alain家“无法无天”的皮孩子们。（摄影：AlainLaboile）	好幸福。如果那时不可以，就永远不可以了。alink
都是是英雄，差别咋就这么大呢。「图转」	超凡蜘蛛侠TMD就是一个除了人名没变其他都重编的第一集
莫言去年称赞重庆的诗作。	老莫是嫌重庆死的慢，加点油。
早说了，Beckham穿这么帅踢球是会出问题的！(转)	很有待客之道，都不去扶的…good
吃饱喝足！坐在大马路上！哈哈！给力！	兵哥啊，冷不冷啊？我咋看着就冷呢？
用橡皮泥捏可爱的乔巴（详细教程）op本周又休刊。惆怅	点解睇上去有绒毛感
各位吃货，你们眼里的中国是不是这个样子滴？	哎。估计博主是北方人，完全不了解南方的美食
太饿了。工作中的午餐	美女，小心不要饿坏身体
有人带着救生圈去救特8上的人了！哇，三环里游泳啊	汽车不再是我们必须的工具，摆渡或轮船才是生命之源。
我眼神不太好，也是看了5秒才看出来。	才看出来原来是条狗狗。太有才老
我相信爱情，只是不相信人。	啧啧啧，人兽恋。冤孽啊
袁腾飞：爱中国就应该爱中国文化，把中国文化推广到世界。	爱国首先要爱国家的文化，这是首当其冲的。
宝贝你真有才。西瓜要这样吃才爽嘛。！	嘿嘿，又快到吃西瓜的季节了。
这首thriller百听不厌，好歌就是经得起时间打磨啊alink	一直被复制，从未被超越的经典。
没了你我因回忆而活因想象而死	没了你我因回忆而活因想象而死
雪地里雪做的香槟台，浪漫🌹！	李开复达沃斯论坛天天关注的都是吃货，甚是无聊！
【国会山】华灯初上，冬意渐浓。	回到你的祖国向中情局汇报工作了吧。不要回到万恶的中国了
FIT输入法开发者冯华君今日病逝。	搞IT的真是用命来换钱。
当一个老外迷上麻将以后。	当一个老外迷上麻将以后。
泸沽湖畔，想在这安静的住几天。	里格半岛呀。真是好地方。！
2011年中国最新恐怖巨作，超越日式泰式恐怖。	终于稳到部百分百惊悚片！
说一个你不想，也不会离开青岛的理由…	因为那是我的家，生我养我的地方。
还记得他们吗？四十多年，一个都没有少。	以前上观赏课没少看呀
我不就是想连个wifi吗？感受到这个世界的恶意………（图转）	好好休息别上网了听话乖
这些英文千万不要不懂装懂。绝对值得一看！（转）	这些英文千万不要不懂装懂。绝对值得一看
#如果玛雅预言是真的#你现在最大的愿望是？	我的愿望是早点来吧、
有些话，我们开始承认了。	事实胜于雄辩，我承认
只不过是一张纸折的！卧槽！（图via马赛克折纸）	这个还牛了，折出来
没有这盘＂葱烧鳝段＂的秋夜，最难将息	什么也米有的夜晚还是好好地歇息了
北京的夜。冰冷的长安街。炽热的红。亲吻！从没改变！	跟谁玩呢？我也在外面呢。
【70年代笑话】形式主义的极致运用。	可怕的是当时的人一点儿也不觉得这样做多傻屄。
关于读书的两张图。	这取决你看到的是什么书自己过得是什么样的没有书的生活
德国球星巴拉克宣布退役，76一代又一巨星告别。	作为76一代看球的，也快要退役了，一年也看不上几场完整比赛
据说，一个中国人死了，倒在地上，拍扁了就是一张元素周期表。	我们身体里重金属太多了！
证监会：动用FBI读心术核查IPO财务	我的娘啊，先会走了，再跑也不迟。
如果我多一张船票，你会不会跟我一起走？from《花样年华》	既然没有如果，为何你不留下来
今天赢了一场很坚苦的比赛。路还长大家努力。11*40我微访谈。	幸亏是夸你漂亮，不是夸你聪明…不然鼻子改长长了………
#爆料#阿里巴巴明天将宣布新任CEO！	小互总是有第一手信息。到底从哪里来的信息啊
#郑在喝水#郑渊洁提醒你现在喝水。喝完水再留言。	喝水太多对肾不好，应该适量，老郑。
中国最难登上的是12306.cn，其次才是钓鱼岛！	哈哈，这是怎样的豆腐渣工程啊
我被智子锁定了，help！	马上启动面壁计划了吧？
我的演唱会越来越近了！好怕怕哦！	好可爱呢，，演唱会，，成功――
六选五，必须放弃一个，你会果断放弃哪一个？	我放弃4……你的男人或女人
即使是小小的房间，也可以让人觉得和温馨。	这个喜欢。很温暖><
高考是这个时代赐予穷孩子的一粒精神伟哥	可惜我吃的是过效药
大过节的去北京！中央台可真会挑日子啊！	没事。月亮还是一样的！
这才是真正的考听力啊！「转」	人家不写直接涂卡怎么办。
做一个简单的人，平和而执着，谦虚而无畏	平和而执着，谦虚而无畏
……这奇葩的告白让我和我的小伙伴们都惊呆了……	好高端洋气的告白方式233
#料理#【学做最好吃的炸酱面】详细讲解请见图	字好模糊，为学个面，眼睛快看废了
没事儿别去接纳什的毛巾……	看似心甘情愿的接毛巾
这球德赫亚一点责任都没有了。	唉？托雷斯转型贝克汉姆了？
挺萌的！（脑残对话安卓端→：alink）	后面毁了。还想着做人不如香皂。
总有人比你努力，可怕的是比你牛的人比你还努力！	总有人比你努力不可怕，可怕的是比你牛的人比你还努力！
富佬迫我一天喝一瓶水。混身不二	这个杯子和我的一样
东西方聊天字符表情的差别：西方人看重嘴巴，东方人看重眼睛。	从表情上看，西方人躺着东方人站着，不解释。
独在异乡为异客，每逢佳节胖三斤。	我想到的是：每逢家杰胖3斤。
半个自由身了，想着想着就要笑出声来	老王和他那四个同事给你面试了吗
一根火腿，一颗鸡蛋能做什么，吃货告诉你可以逆天。	好看，就是有点油，吃了会胖吧
大家躲远点，接下来施展的是个禁术：「忍法•双眼皮之术」。	不动时有一种唱吧头像即视感。
用心甘情愿的态度，过随遇而安的生活。	喜欢这句话，也喜欢这张图。但是现实中有几人能做到哦。
民国上海---南京路河南路，哈同大楼老介福绸缎局	西门子这么早已进入中国了
舜耕路上已经水流成河了！	我这太阳高照一点也没下
如何辨识你身边谁是蝙蝠侠。	晚上的太阳镇厉害==。无法直视啊！
有意思，林肯和肯尼迪到底有啥关系？网上看来的。	这绝对不是巧合。！
我在广州，二十三岁，想去马尔代夫，一个人。	我在潍坊，26岁，想去北京，一个人
历史文档，贝志城2003年2月的信。	贝同学，好人！真好！
你只适合思念，不适合见面。	你只适合思念不适合见面
人民网再涨停，市值已达130亿元人民币！alink	7.1前争取市值干点“非死不可”
职场三定律：要么忍！要么狠！要么滚！	它不会给你避风港。
人生啊只要能够在善良里去快乐，还有什么不值得感恩的呢。	好可爱又让人怜爱的狗狗
2012——各种偶像陆续坍塌的一年。	天后老了嗓音真的大不如前啊
心情终于好了，中午吃到鸡蛋了	哈哈···迪奥古好可爱····好好保护他耶
可以输给对手，但不能输给失败！	成功者总是不约而同的满足时代的需要
看到心酸，中国的传统文化，传承很困难！	唉。天朝现在失去的又岂止是传统文化呢？
小时候喜欢这样玩的童鞋请转发。	啊哈哈，真的好怀念哦！
贝卢斯科尼又因为性丑闻被判了7年。	所有判决加起来有没有200年了？
很多东西，不是想，就能抓得住。睡了，安。-alink	不是想。就能抓住。哲理
每天早上心情都特别好！	每天晚上心情好……
人类再也无法阻止老外包饺子了！	果然是追求速度的，连饺子也快成这样。哈哈
据说是3年后会流行的女生短裤，天啊，这个创意不会是真的吧！	早流行过了。好不好。！
转：成功就在坚持的下一秒！	成功就在坚持的下一秒
下大雪时，小猫是这样走路的	雪大了猫就变成了兔子
很多时候，看的太透反而不快乐，还不如幼稚的没心没肺。	必须的，我就这样，谁怕谁啊
如果拿你身上20斤肉换取母亲十年长寿，你愿意么？愿意请转发	太愿意了。赶紧拿走！
原来这就是遇到对的人的感觉。「转」	人生在世，需及时行乐。
#郑在晒晚餐#吃晚饭了吗？在哪座城镇或乡村吃的晩饭？	老郑发这个有意义吗》有毛病啊！
那些艺术大师和他们气派的画室。	阳光温热，岁月静好，你还不来，我怎敢老去。
祝大家情人节都陪猪过！	对朱八的儿子比较有兴趣。
地铁里抢手机的贼，大家小心……	这个厉害咯！靠门玩手机有风险！
早间阅读：≪青年时报≫上的文艺好青年。	处女座不要太追求完美啊。放松放松
某地大旱，灾民祭祀求雨，供桌上摆的全是萧敬腾爱吃的。	listentotherythmofthepouringrain！
真的问问大家，你们想看到什么样的体育新闻？	网球新闻！不要一直说费天王喜欢小德的也不少呢
考生加油，你学的东西过了这两天就没用了，不要有所保留！	寒窗十几年就是为一个分数吗？阁下中毒已深！
两个250第250条微博睡觉周五北京的干活	两个人都笑得见牙不见眼，不过牙齿都好白阿
2012年6月17日父亲节，有心的孩子转一下记一下吧！	一幅图片，却勾起回忆满满。……
需要的童鞋请转走！	我猛一看一位后悔药呢，好吧也来一罐！
男人们真心不容易啊。姐妹们体谅一下！	男人们真心不容易啊。姐妹们体谅一下！
alink灯杆上的足球，高手一直在民间。	配乐是什么呀，很有节奏
我的愿望是，一觉睡到小时候。	我的愿望是，一觉睡到小时候
你好，大鲸。丨摄影：BrianJ.Skerry（1600x1063）	你好，渺小的＂鱼＂
万能的神啊，保佑转发这条微博的人都梦想成真吧！	万能的神啊！保佑我们吧！
#投票#如何看待李娜奥运低迷后反弹？alink民调中心#	输赢都死她自己的事
白塔山背后，好像正在拆迁。	为迎接你的到来而拆迁。
【心灵探索】不以结婚为目地的谈恋爱，都是在替别人养老婆。	不以结婚为目地的谈恋爱，都是在替别人养老婆。
如果有天你手机停机了，谁会为你充值呢？	hu粉hu粉hu粉hu粉hu粉hu粉hu粉hu粉hu粉hu粉hu粉hu粉hu粉hu粉
以我的性格来说，其实一定宁可两边是不对称的！	就是就是，我也会爱不对称的，特别是这样的花型
看看亚马逊和申通在忙碌的时候的区别。（转）	管理一下比较省时间
【一张图告诉你守门员曾诚有多勇猛！】丨来自:央视新闻	必须转，昨天能跟棒子打平，绝对离不开曾诚神一般的操作。
【求证】这就是撕毁“西哈努克画像”的那个中国女子吗？	致敬！外交部啊，哎
一个从互联网行业跳槽到公务员的朋友写的，写的非常受用。	第一次见到缩略图看着这么整齐的文章
训练有素。那个，那个第三位童鞋，麻烦把你的狗腿拿开！	狗腿！真的是狗腿！
如果你在背后议论我，那只能说明，我活的明显要比你精彩许多。	有道理，那些大喇叭应该反省下了
见朋友家用过季的菜苔作插花，小黄花雅致，挺美。	还可以用透明的玻璃小瓶子养大蒜。
雷：在严复翻译时很难才找到了自由这个词。而今天仍未实现。	这话很“炮”，尽是牢也牢不住的“牢骚”……
希望大家帮忙转发人肉昨晚偷走了我的笔记本谢谢大家	找到直接弄死···妈勒···
死前一定要破处！不然上面会有恐怖分子等着你啊！——教堂标语	哈哈哈，72个处女哪比得上72个经验丰富的熟女！
老师……抱歉……我古诗背串了……【全文】alink	再次印证了高手始终隐藏在民间！
闵行又倒楼了，万恶的豆腐渣！目前8人逃生，3人被埋！	都是奸商干的好事啊，奸商们你赚这钱能睡着么吗
#笑一笑#「贤惠」，顾名思义，就是「闲在家里什么都不会」！	以后别人就不要说我贤惠了，我会翻脸的
这几天收到你们发的图片，希望我没有忘掉谁的！	擦，，我的图片呢！
最近和古镇文化委有一个戏曲合作活动，今晚先来彩个越剧选段…	哇，聪聪老师，真希望能看到啊。
二货主人，你敢再无聊点么。（转）	噗哈哈哈这猫会被虐cry
你们遇到这种情况一般怎么做！	哈哈哈哈哈哈哈哈哈哈，开玩笑、根本不可能遇到！
#雅然·趣玩#夏日洗脑铃音大循环。你的铃音是什么？接下去！	Ijustcan'tgetuoutofmymind
年轻时的林青霞，无需施粉黛，美人自清丽。喜欢的转走吧。	东方的美是依旧的美啊！
《怪兽大学》内地提档两天，8月23日上映！	大眼仔！不见不散咯！
施华洛世奇哆啦A梦水晶头盔。带上它骑摩托，拉轰死了。	反光太厉害。容易被撞。
吃完朝鲜冷面，听胸前佩戴国徽的服务员唱《卖话姑娘》主题歌。	是平壤银畔吗？588最低一位
特别烦这货的请转发！现在有点怀念它的也转发！	初中老是做。高中也要做
啃西兰花的小仓鼠，好萌哦。	哪能好噶可爱的拉！。西兰花小鼠
【测试一下你的右脑】你能看懂这篇文章吗（CCTV外语频道）	。想要健康吗？想要长寿吗？那就关注我的微博吧。
灵犀：未来移动互联网的重要入口alink	我在用，还不错，主要是很方便！
英国网友票选出15大最爽的瞬间，世界大同啊！（转）	哈哈哈哈哈哈没错都很爽😁😁😁😁
突然想到一个很严肃的学术性问题，是谁把60分定为及格的？	TMD，这是个问题，同问？
不要让忧郁淹没了你。「转」	对啊，说得没错了啦！
权振东的声音散发着一股韩剧主题曲的味道，不过我喜欢。	确实。亲爱的小孩唱的蛮好啊。可惜了。
你才是球，你们全家都是球！(转)	这造型是洗剪吹的。
海景房不用买，等一等就会有的（2013年8月拍摄于香山，北京）	那得能坚持活到2013年。
万年屌丝要从娃娃抓起！	哈哈我也截过这一段。
网友图解新闻联播与新浪微博的区别。via：企业家智库	我觉得这图还不够准确，更准确的是微博部分局部打马赛克
#灵异#一觉醒来，脑门上出现了一个＂8＂字。什么情况？	内幕只有你自己知道
赶上21cake给出租师傅送蛋糕……我也想吃了	捧着满满的爱心啊这是！
据刚刚得到的消息，城区供水水压有所波动，正在逐步恢复。	理由太官方了，没有真诚！
光棍节快乐无比！在宁波拍摄#搜索#，丰富的午餐！	光棍节快乐，我要告别单身啦
宇宙篇：你从没见过的23张图，让你有一种莫名的恐惧。（转）	我们都只是尘世间的一颗微粒
矮油，好恩爱的一对！真让人羡慕！	搂搂抱抱亲亲我我。
【童年记忆】为这个东西开心半天的小朋友。现在都不小了吧？	春游必备几大件儿之一。>.<
如果苏醒遭到封杀，……那我现在就该还躺在被窝里。	眼睛一闭，不睁……不要开这么危险的玩笑！
【最后一个故事】（莫言诺贝尔演讲节选）	这个结局，还真没猜到。
华仔跟我说：「我怎么可以这么帅？」#随手拍#	美得一切都静下来了。看着让人静心。
天然呆也有春天！老张看呆瓜，越看越喜欢！	俩娃对上眼了嘛你出门去他俩不知道在家干嘛呢哈哈哈哈哈
专业人是怎么称呼颜色的？原来如此文艺，语言的意境。	我现在才知道啊我的颜料都白买了
卧室与泳池连在一起的房间，你喜欢吗？(转)	喜欢啊可是太潮湿了吧
爱上你，我真是病的不轻。———刺猬小姐对仙人掌先生说	刺猬小姐和仙人掌先生的爱情。加油！
是的。没错。凌晨3点57分。今天又决定不睡了。	我也已经好长一段时间没睡好了.失眠久了连睡觉的欲望都没了
点一下，点一下……模仿三格半。	闲话不过就是那些人把羡慕当作嫉妒说了出来。
给强迫症患者用的菜板alink	强迫症，几何控，要做饭了
鳗鱼蛋卷炒饭，这叫我怎么吃呀。	看上去好没食欲啊。
李宁的销售速度，太猛了。	貌似上午就已经大量售罄了。
有多少孩子做过这种爽事，有过的转发吧。	被老师罚抄时试过！。
世界亏欠我们的，我们互相补足。	五姑娘和好基友的鸡汤版本
【飞龙在天】2012利见大人，中国股民发财发财，恭喜发财	我看还是别提股票了，破坏气氛。
网易数读：乳业巨头一年70亿广告费可以怎么花	喝奶的时候想想有多少广告费用在里面…
泰国水灾中的人民智慧。最后一张亮瞎了！	果然，人是被逼出来的……
为了给市民带来夏天的凉意，某地地铁将地板画成了这样。	哪个市这么洋气啊、
有什么比喵星人更令你开怀，乐足半天！「图转」	喵星人是上帝赐给人类的礼物
睡不着，几个月来我远虑天下事，近忧女神心，失眠不知多少次。	老师真乃我辈屌丝楷模
菜花迅猛地丢掉了刚在BV买的钱包，太惨了T_T	你重新买一个送她，她就高兴了。
回到家把身上的零七八碎都掏出来了	这床单儿，瞅着也是个老物件儿。
这个必须推广，绝对够凉爽！如果换成麻将会沉吗？	想试试的童鞋，伸个爪。
这小子累急眼了，要拎棒子打人去	看来他旁边的要遭殃了，谁啊？
像草莓般可爱。仙人掌般坚强。	爬爬是草莓也是仙人掌
相机广告，挺考眼力的，看大图找找看，谁是凶手	下面小相机里就是凶手吗？哇哈哈多年找不同练出的眼力有用了。
为何觉得行贿可以原谅？alink	受贿的除了坐牢没有损失，行贿的除了坐牢，钱也没了
书架整理程度62%。困意62%。剩下的三八谁来负责？	昨天晚上甘肃台的做客嘉宾是你不？求证
二逼青年、普通青年、文艺青年、失足青年（浏览器版）	IE9应该算在哪个行列里啊？我想算在文艺青年好了。！
#吐一吐#周末没人约，好寂寞！	不会啊，至少还有陪！
这就是村民家里屋顶上的蓄水池	下边不怕潮湿吗难道就。
环境不造就人，环境只是揭示和显露了一个人的潜能和真正面目。	环境必须是改造人的
#量子晚报#第205期：【如何留住用户】	#干货分享#如何留住用户
那个叫“我”的天真小孩，离开我很久了，找不到。	但愿明天，“我”能回来。安了
人生最大的痛苦，是“想得到”和“怕失去”。	我同意，不过我最大的痛苦是怕失去
其他国家是民富则国强，天朝是民富则移民。	你知道中国人有多少人在等着移民吗？绕地球3圈！
我勒个去，这个才是真正的功夫熊猫啊！	妈妈让我从小就练武
盛大文学起点中文网重要公告	小扑街不会得到什么好处的，大神才会财源滚滚来。唉。
很多公司都放假了，约不到人聊天，郁闷！	很多人都回了吧？您太勤奋了！年后求聊天！
想办一本体育杂志，诚招主编！有意者留言，也欢迎大家推荐人才！	请问您需要怎样的主编，能具体点不，地方在哪？
成都日系车主亮了！「转」	妈的，这个车主是怕自己的车被砸好吧。犯贱。
喵是特种兵，DIY猫咪迷彩。（via臭猫控制下的LC）	这年头做只宠物真难，被各种2B主人折腾
其实，滑动解锁是咱们中国的专利！	没有新内容了啊？隔一段就发重复的
松风清一缕，鹤立自从容。心有闲云渡，何须觅雅踪。	心有闲云渡，何须觅雅踪
结婚，到底是为了什么？。推荐给男男女女们看看！「转」	喜欢心如的粉丝，就关注
今天的午饭，韭菜炒鸡蛋和鸡蛋炒韭菜，丰盛吧	这是你们的伙食么。以后谁还敢去你们公司上班啊
欧洲小镇上老工匠做的海螺，这雕刻手艺，真心碉堡了！	螺蛳壳上也能做道场，欧洲艺术家都隐匿在小镇上。
大早上用电钻的，都应该拉出去枪毙五分钟。	晚上十二点之后还在呼啦呼啦搓麻将的也应该拉出去杖毙！
体重不过百，不是平胸就是矮。（转）	这就已经该满足了好吗？郁闷的是体重过百，又平胸又矮！
2.自信地生活；13.淡忘仇恨。	我目前心中有仇恨。很难淡忘。
刚喝了一盒国产牛奶。	一杯没事，每天一杯可能出事
华丽而性感的伴娘装，太唯美了，你想拥有吗？	哈哈，让我成为你以后的伴娘
#季后赛酷图#加内特原地满血复活！	向老兵们致敬！KG加油！
今年2月到现在你看过的电影哪些可以入围明年的金扫帚呢？	天机--富春山居图绝对的榜首
哪位大仙能解释这个问题呀	英文跟中文难道是同一个人发明的？
朋友们早上好，今天的空气质量。	中美同发，居心叵测
这才是真正的“牵手去旅行”	将来也要找个会拍照的牵手旅行。
#三字经英文版#大家一起学习学习吧！	sexisgoodIfyoudontlearnyoucanbynomeansenjoyitssweetness
一位外国妈妈为自己8岁的孩子做的。愤怒的小鸟蛋糕。有才啊！	其实盒子上印着…MadeinChina
【英语中常用的123个成语】这些你都知道吗？不会就收藏吧。	英语中常用的123个成语
徜徉在像花园一样的家中是一件多么幸福的事。	貌似只能在希腊这么做啊
你确认那些东西还和你当年买到的一样？	真对，价格标签都上去了。
【提神专用】：第52届国际小姐中国大赛重庆赛区季军！(转)	大家就不能关注一下内在美，智慧和才艺吗？外在美这么重要？！
我有一丝奇怪的心情。	这副小面孔还能灾纠结一点儿吗
看了杜今儿的遭遇，姐以后再也不敢乱删微博了。	60E杀到推特了好家伙
懒人级韩式花苞头。（转）	头发不一样长(⊙o⊙)哦
万能的神啊，保佑转发这条微博的人都梦想成真吧！	保佑我明天要成功。
阳光透过彩色玻璃，这种感觉，真美妙。	真好吃的样子……
孔圣人曰，近则不逊，远则怨。这是说谁的啊？	你这是自找苦呀，吃小心女人骂你
时常收到这样的私信，我该怎么处理呢？	这是个玩笑，别当真吧！
#每日一神句#假如生活欺骗了你，你说__________________________________。	假如生活欺骗了你，你说，你为什么不强奸我？
上传了1张照片到“微相册”。alink	英文杂志不错啊。恭喜！
在行动中思考，在生活中修行。	努力按照堪布说的去做去修行！三顶礼三宝堪布！
周六周日希望所有烦人的人都別来烦人！	每周都要说这句啊！
早一直觉得我们台有一天会发射升空的	多蓝的天呀！跳吧！和这蓝天融和在一起。
【趣漫画】这家伙……技能点错了！图片来自imgur	有一种神奇的生物，叫别人家的猫…
普通狗，文艺狗，和2B狗。	哈哈。最后一张太2了！
每个人，都希望成为另一个人，或被当成另一个人。	哦？自己有那么不堪？需要琢磨琢磨这个事
痘痘告诉你，身体哪里生病了！（转）	压力大脾气差···
和一个人聊天，只要TA说了一句“呵呵”，好感度立即下降80%。	是的是的！总觉得那个人说了呵呵变现的是不愿意搭理我了！
仔细想想，人活着其实就是在销售，永远在销售自己！不是吗？	洗脑的成功学、、成功的洗脑学。
做手机的应该选择android，做移动互联网的，应该毫不犹豫的选择iOS	一鞠躬。二鞠躬。三鞠躬。拜一拜。
国足比赛凌晨1点，现在才10点半，怎么捱呢？	我知道你想说聊五毛钱的
靠，我又失眠了，很困，但是脑袋里静不下来！MD，真难受！	可能是抑郁，崔永元也是这个问题，抑郁导致睡不着
#NBA酷图#一转眼，雷已近不惑	总决赛第六场那个价值千金的三分，应该是马刺的梦魇了吧！
第一天适应比赛场地，感觉不错！我在:alink	游泳池水很干净吧！
微信，历时433天，从0到100，000，000用户！weixin.qq.comalink	强烈要求微信出Meego版！
第一次做寿司，果然很容易	想起了以前在大学宿舍里做寿司的日子。
一针见血的品牌定位，各位骚年赶紧对号入座……「转」	一不小心我成失足青年了。这个让我很惆怅啊。
缘来要惜，缘尽要放，随方就圆，无处不自在。	缘来要惜，缘尽要放，无处不自在！
唱红歌，是爱好；组织唱红歌，就是政治，反动政治。	工作不好好干，上班去唱红歌，还给发工资，这个算不算渎职？
健康小麦色美腿，这太叫人艳羡了。	白的是不是更受欢迎？
这一年，让一生改变。这一刻，愿放下，感恩。	和我同天生日哦。生快
看这大house诶，还真verynice！	貌似瘦了，还是瘦了好看。
其实，善良比聪明更难，聪明是一种后天天赋，而善良是一种选择	人对于选择总是最难的
好吧，彩排结束，我要去眯眼一下。BTW广州大学城真的好大！	魏晨童鞋，加油，演出橙功！
我觉得这个电器一定是想暗示我什么。	上面有奇怪的液体！
所有的好友都住在同一幢公寓里、这是我的梦想。（转）	是阿方便串门以及吃百家饭害怕了还可以到处睡
这么开心的一天欢迎小外甥来到这个世界。helloAdrien	刚出生的孩子不能拍照。懂？
#趣图#求助：这车里坐的是什么啊。	孩子们！座椅套来的！
真的很多人分不清白百合和王璐丹啊。	你也分不清王珞丹和王璐丹啊。
象梦一样自由，象天空一样坚强，象大地一样宽容。	天空为何坚强了。三不五时的来个阴霾来个大雨倾盆的。
早。今天聊：在什么时候或者事情上面你不好意思开口	对面吃饭的人biaji嘴！还有找别人还钱的时候不好意思
公司请的培训师，讲到倒在地上哭，这丫太夸张了。	这个公司负责培训的完蛋了，除非公司老板是白痴！。
适合情人老公突然回家，从容逃脱的房子	一回生二回熟，带俩人给堵了
在有这样外景的会议室开会，你还会觉得累么	估计到时候领导讲的什么都没记住
这个抱枕实在太逗了。	哈哈，哪天回家不注意的话会吓到的！
有深度的一组插画，若有所思啊……	有深度的一组插画，若有所思啊```
节目安排随赛事进程以实际播出为准	不要再让孙正平解说篮球了
妇联退下，该我秀一把了！	还是更喜欢高富帅钢铁侠
我后悔小时候没干这事。（转）	我细个噶时候经常都同大佬玩哈！
斯诺登向中国等国家提出避难申请。	中国应该敢于表态…
#Lens夜话#在夏天你最喜欢______________	睡午觉起来吃冰水果喝冰咖啡
试试这条微博的阅读量有多少。	刷到没点进来的也计算吗？
昨天晚上做梦我回西安翻译学院了，还住进了南一。	下次西安话测评吧。
表白这件事，如果做的好，就叫做逆袭（图改编自网络）	可能吗，连杜蕾斯都买不起的青年。
韩国的整容技术太思密达了，这还让不让人活了！	我艹，那照镜子还认识么？
谁在画室不努力，谁抠出来鼻shi就是白的。懂得转。	因为炭笔的粉末是黑色的吸进去鼻屎就黑的
高中的课本，曾经这样写满的情举手！	以前感觉写的越多学习越好后来知道写了也白写
这孩子相当有前途。	学生，老师，教育，都是失败。
日本餐馆的厨师叫头，给客人用一大木铲送菜。	你很喜欢日本吗？你是中国人吗？
不想失去，不仅是保护好就足够，而是让对方也变强！	不想失去，不仅是保护好就足够，而是让对方也变强！
男人应该是A还是B？「via佐敦道12号」	应该的a，不过现在大多喜欢b
转一转，好事将会发生在你身上！	我现在真的需要这个。
今天，无缘无故，心情很好，多谢大家！	我发誓填词一定要超越黄伟文林夕
放假是不是只顾吃了，有没有跑步啊？	喻舟好棒，明天我也要跑！
穿成这样不是讲数就是收数只需预防意外中暑。	我决定了我要追你！
用一句话证明你的家乡是哪里！	天心阁，阁中鸽，鸽飞阁不飞，橘子洲，洲旁舟，舟行洲不行。
这张图名为《It\'stoolate。》，太辛酸了！	树欲静而风不止……
宣布Siri正式支持日语了。	日！中国市场永远都不在最重要的位置！
史上最敬业电灯泡。（转）	艾玛，我竟然哭了要幸福啊（握拳）
2012地球不会毁灭，因为多啦A梦告诉我们他是从2070年来的.^^	要是纹身就纹个哆啦A梦
《生活大爆炸》四的主角原来也可以这样有深度！	但是看到谢耳朵还是想要笑怎么办。
靠，这是个神马情况？我就想看看成都哪里适合逛逛都不行？	很奇怪很恶心的审查制度，而且邮件的内容也要被过滤的==
贪吃蛇真是一代经典！P.S.卧槽我竟然把它看完了。	都是坏人，哪儿有半小时，害我看评论没看到结局。
失望只有两种可能：选错了人，或是怀有不该有的期待。	失望只有两种可能：选错了人，或是怀有不该有的期待。
如此给女朋友过生日，这样的男朋友你还要吗？	我掐死他的心都有了！
十五年弹指一挥间，再回首恍然如梦。	莱昂纳多和凯特，十五年，太过匆匆。
传说中的漳州第一小吃——鸡仔胎！厦门的童鞋吃过没？	明明南京六合名产活珠子
不减税会死一些企业，那税也没了。要算清楚，减与收的关系。	象这样釜底抽薪的事做的还少吗！
这个时间这个星球清醒的人越来越少。··	那么好看……这是哪里……书呢？
【星爷的电影有远见啊！】alink	荒唐的狗血剧情一幕幕的让人目不暇接
两个人的书房，看看哪款适合你。	幸福，可以是简单的两个人呆在一起。
钟南山:英国用30年治霾北京下狠心10年就成alink	需要拿出抗震救灾的决心治理空气污染
【国足VS澳大利亚】目前比分：国足4-2澳大利亚！	这是我的打开方式不对…
时针，注定是个胖子。	难怪时针是最粗的！
比赛结束，各位开始吧。	大家一块预测下本赛季意甲第一位下课的教练是哪位呢
貌似北大那边着火了！最近中关村附近还真是“火”	好高的楼，汽车都变成小火柴盒了。干燥天气注意防火噢。
男孩干过的傻事之一，女孩称之为浪漫	最后男人开始浪了，女人开始傻了。
今天奥林匹克森林公园。跑完步后拍的照片。	像潘小时候熟悉的风物吧。
丝袜不要买那么黑的。	呵呵。丝袜质量太好了
一位超级有想象力的中国妈咪给宝宝拍的照片，真是太有才了！	最可爱的妈咪与宝宝！
轮渡，一笑就没有眼睛的人真可怜	大白腿啊！话说哪天问问你厦门旅游的攻略啊！
#下午时光#你想不想，在菲律宾，小憩在蚕茧形吊床中。	要很粗的杆支撑着才行，碰上两个大胖子那是很悬乎的
超级人性化的设计，抱着你心爱的TA一起入眠吧。	这个喜欢，睡觉这样真方便拥抱
真正爱你的人不会说许多爱你的话，却会做许多爱你的事。	也说也做才是王道好吧。
世上没有绝对幸福的人只有不肯快乐的心	为你转得。希望你真正的开心快乐起来！
每次经过天安门，都会看到毛主席深情地凝望着对面的自己	这份深情，总让我很不安。您呢？
好固执的小家伙。宝贝，还是下地走吧。	小浣熊啊，看到他真的没了脾气
我觉得还是不要告诉他真像比较好。	悄悄告诉我吧，我不说出去的！
时光如水你舍不得喝，光阴似箭我可劲儿躲。	时光如水不解渴，光阴似箭躲不过。
尽力之后再随缘。晚安。	今天才看到残达提到了一句类似的。
【屌丝眼中的各种大学专业】你的专业躺枪了吗？！（转）	哈哈哈。哲学汉语言文学都亮了
吴佩慈征战巴黎时装周，搞怪、名媛、时髦，各种风格穿起来。	她卸妆是女版黄立行
今晚在家晚饭，来一尾清蒸鱼，有同道中人吗？	我地屋企蒸鱼只用葱姜，不会用芫荽
张家界天门山。如果你站在这里，你会说一句什么话？	绝对是南派三叔的插页。
黑猩猩的大肥屁股生孩子红红的肥屁股钻出来黑黑的娃(GIF3.1MB)	刚开始还以为是头部
作为一名伟大的吃货你必须知道的事情。（Fatooh）	哇。我也试过好几种了。
这才是街拍！——VictoriaBeckham&Harper	已经足够理由起诉这个妈了，无论她是谁。
【春晚精彩照片——《致敬三十年之<我的中国心>》】	老了啊，不过听着歌还是很有感觉！
复印黑人的证件请用高档复印机……	好恐怖啊。像外星人。
我确定介货不是我亲生，大家相信我的清白	浮云啊，神马都是浮云啊
居然找到了！原来真的有啊==	我也用谷歌找了，真有啊！太帅了！
中国民营资本将进入被“围剿”时代alink	如果这样说，那现在还适合够创业吗？
2012年欧洲杯完全赛程，准备好过这个夏天……喜欢的朋友收藏吧。	注定这个六月不能平静咯。
主人！你居然背着我又养了只喵？	我家也有一只这个偷钱猫
气不和时少说话，有言必失；心不顺时莫做事，做事必败。	如简单的道理，但常人就是办不到
汪晖只是“不够漂亮”，我愿说声抱歉先alink	再别说了，他的徒子徒孙已经把你拉下水了
#我家有只大仓鼠#这货不是猫绝对不是猫喵星人的脸都被丢光了……	61啊，终于你逼我承认你2了，可惜了我整天心理叫你小天真
据说屌丝的短信箱是这样子的，躺着中枪的直觉转发吧。！「转」	这就是俗称的躺着也中枪的赶脚吗？
用飘柔，就是这么有自信。	用飘油，就是介么机信。
今晚一场斗志斗勇的恶战！加油兄弟们	加油！我们支持你们！
路上遭遇乞丐，给还是不给？纠结。	我给10块，换他脚下的那块“小白板”。
十大打老婆地区排行榜！。你呢？	没懂，为什么贵州没肉吃打！都是极品！
为什么受伤的总是他们。	保罗帕克德隆库里他们危险了。
世间最痛苦事情的莫过于此。	喵星人实在是太可爱了！萌死了！
我想不磨皮，又能去掉满脸的斑，就是这么肤浅。	哇塞。好亮的眼睛！
没有高考，你拼得过官二代吗？	官二代都去美国上大学了，不用高考。
这些广告告诉我们，眼药水用多了长不高。	小心那些有用眼药水的人“我一口盐水喷死你”
alink听说大家都有Git。我刚弄的。	你要把你的代码放上去才行
赢下那张船票是我一生中最幸运的事。——《泰坦尼克号》	丫，，曾经看了几遍，哭了几遍呐，，
【每日一萌图】有只狗，名字叫做小清新图片来自alink	尼玛总是笑得那么开心干嘛！
#看图猜电影#兔子都是浮云。这是哪部电影？	天使爱美丽哈哈哈终于有知道的了
分享图片结束蒙餐回家休息	左下角那个碗里的是什么啊？奶茶？
在餐厅内撞晕的小鸟。科学岛就是生态好。	好是好，可是在动筷前要注意下盘里！
看到这，我只想说广告是一种。艺术！	谁真有这本事太diao了
还是那句老话，不怕神一样的对手，就怕猪一样的队友。	还是那句老话，不怕神一样的对手，就怕猪一样的队友。
听说这是最新的奥特曼。二货啊！	这迅速的反应，不愧是奥特曼！
早起的鸟儿有虫吃，各位早安！	你每天早上都有吃虫子么？
千万不要相信你的眼睛。！	好可怕，是用了错位原理吗
八戒，是你吗。你以为戴个草帽就认不出你啦？	八戒，上辈子你做不成人，怎么这辈子还投胎失败呢！
没有这盘阳澄湖大鳊鱼的秋夜，最难将息	阳澄湖大鳊鱼确实好吃！
还记得那个无聊的星期二下午吗？你都是怎么打发时间呢？	一不小心立马就三儿了啊。熟悉又凄惨的图画啊。
凯旋门和万变的巴黎天空。	开复老师近日游了好多国家呢。
【蛇吞猪会发生的怪事】alink	这有点太“迪斯尼”了吧？
我房间有一只老鼠，我坐在床上在跟它对峙，看谁先跑出这个屋子	卡夫卡的真实与荒诞，诗人走饭
在吉林艺术学院门口瞟到的。给跪。「人人网友」	果然是毕业的不如在校的老师又不如学生
据说，嘴唇常常干裂的人是需要一个男/女朋友了。	啊？那我是一直不需要啊？单身时候也不需要？
求证，这真的是小学语文课文么？科幻题材还是灵异题材？	没准是60年代的故事，嬉皮士之类的……
请问：我刷新下微博之后能看到点儿和中国好声音无关的内容不？	目前不能，二半夜试试
妹子真会玩手机自拍呀，随便一拍就亮了……	尼玛，很多KTV都是如此的，好不？
其实女孩要的东西很简单，但大多数男生都不懂……viaecho小茵茵	是永远得不到的才是最好的吧
换季容易过敏，大家要多注意	的确过敏了。每次换季都会。怎么改变？
箱根温泉----老火车铁路、树林、涌泉、水声漫漫、安静而疗癒。	这身着装非常合适你！
小时候喜欢这样干的童鞋，请举手。	这是变态心理么？我喜欢诶。
alink，OMG，苹果平板iSlate的短视频，真的吗？	假的吧，看关闭窗口的小x应该在左边！
试过薰衣草冰淇淋吗？淡淡的清香，特别的口感，吃多少都不腻。	冰淇淋好吃，碗好看。
卫生巾也走复古风。介个，大家怎么看的。	布的？反复使用的？
谁为你倾尽年华，谁又为你海角天涯。	我做了前半句，你能不能做到后半句？
昨天讲的没想到今天就开始预演十年期国债破1%了日央行只能硬顶	这个样子的话，日元又将继续下挫
无所不萌之广西南宁。下次见啰！	好可爱！右下角那张，宝弟的脸是一个囧字。
她不是很漂亮，但就是很喜欢她和她的歌，加油！	我也刚看完，声音太好听了
#郑在拍摄北京#我今天拍摄于北京。	这是伦敦，绝不是北京！
当泪的潮涌渐渐退远，理想的岛屿就会浮现。（顾城）早安	还在难过是因为还不够。
大萌在吃北京烤鸭。	亲，小心禽流感哦…
理财周报：马云帝国内幕alink	公关马家军怎么还不出来！？
球衣半遮面有点印度皇后陪同皇上出游看球的感觉。	正在纠结晚上要不要过去。我明天还得上班啊。
这轮行情不是针对散户的。	这轮行情是针对整个中国的
今天《非你莫属》邀请了一位明星嘉宾，你看他是谁？	忘记谢谢博主分享照片
江浙皖一带是哪位大神在坐镇……	真的！是哪位大神？天天那个热a
元宵节快乐，娱乐考试开始：请看图猜成语。	走马观花惺惺相惜杯水车薪哭笑不得美中不足happynewyear！
你有多少钱，也买不来它们。懂得珍惜才是幸福。	免费的，也是最贵的。
有人看中国好声音吗？我请她吃葡萄，很珍贵的葡萄哦。	这期没一个有我的声音好
微风正好，走，饭饭去！	您在哪？我想见您，我大老远从广东过来就为了见您一面。
你才是拖鞋，你全家都是拖鞋。	你不是拖鞋是雪地靴
看到这张图90%的人会把手往屏幕上按！	尼玛，，我刚刚按了。
我根本不怕你不爱我，我怕的是终有一天我懒得再爱你。	也怕你不爱我了，也怕我不爱你了
我希望我的下一场恋爱，要么，不开始。要么，一辈子。	我已经不知道什么是恋爱了！
小样儿很会装酷嘛。车链都木有，看你肿么骑	小样儿很会装酷嘛。车链都木有，看你肿么骑
战争让人心丧失爱。你没有经历过战争，怎知其残酷？	领导人自己去单挑，老百姓伤不起
刚收到的，大家把照片处理了一下，很有意思	连起来看，好搞笑啊，你们都累不累？一直吹
拿包、拿钱、丢节操！请！还包、还钱、还节操！alink	你圈自己出来的下一张图，不是挎着包包出来的吗？
中国是这么形成的！（via历史解密网站）	最辉煌果然是元朝啊。成吉思汗威武。
苏格兰的清晨，阳光下花朵绽放，想在这停下来闻闻花香……	这一切美的失真了……
【禅悟】一念起天涯咫尺一念灭咫尺天涯。	怎么重复发同样的微博？
谁来阻止麦当劳的创意总监？	强大的麦当劳叔叔！
今天有不少医务人员还要值班，感谢他们！祝福他们！	咱是白班，现在看春晚了。
看图知真相看到最后，我承认我心酸了。(图转）	小时候，可是很爱这个调调的哦！
超有爱手绘，作者用手帮小男孩起床、洗澡、吃饭。「转」	会画画的人真是厉害呀
上海排名前五十的餐厅，你去过几家？	同感排名不准，3、5、15、29、34、41、43去过了。
情人节单身的差距，哈哈，超市约会的开路	这是哪里的超市啊，好想偶遇你们
八达岭、不八达，憋得司机满地拉alink	今天路上也憋了一会，还好时间不长，不然要纠结了。
原来这世界上还有一种宠物叫别人家的喵。（图转）	喵了个咪的都是火星来的吧
古代父母对孩子的“七不责”，现在也同样适用啊！	第2点难执行，因为家里小朋友比较难有惭愧的时候
一朵鸡冠花正在歌颂茉莉花	哈哈哈，刚刚就觉得像。
离京几日，停博一周。小别，各位亲。	每日留言以示常来。
＃郑在喝水＃郑渊洁提醒你现在喝水。喝白水。喝完水再留言。	每天在家都喝白开水，在单位只有纯净水
大人理解不了的孩子眼里的世界。	小学时候就这样好怀念。
【视频】Discovery探索频道-建筑奇观：北京地铁系统。alink	喜欢建筑类的纪录片？
GGJJDDMM们，请问渤海4月有什么海鲜好吃啊？螃蟹好嘛？	嘿嘿，有啥好吃滴牙？
日本的电视节目一大早拿中国游客的事儿吐嘈，今天是个大阴天。	不文明没素质的中国人真的很多！宿舍就有
据说坐过这个座位的人90%后来都是精英！	不只精英那么简单''是BOSS
挪威国旗真是万旗之母啊……	考试考各国国旗考得恶心死了，这条微薄倒有点意思
刚去吃了黄亚细肉骨茶。好吃，但还不算最好吃！	骨茶是啥东西？怎么看着想排骨汤
#泉夜曲#路无止尽；只有向前。	今天终于回家了，摘了几天的花椒，手指都破了，好累。
我能做的不多，但你需要的时候，我在！	说的和我一样一样的
Mac上现在有了更酷的Foxmail！alink	腾讯已经开始大步迈进Mac了。
养只金毛和养只哈士奇的差别真是太大了！「转」	狗狗们太可爱了，好喜欢
日子不好过！税要来。	我还以为全部都征税。好再是大卖家才需要。不然兼职做不成咯
人生的旅途中，总有那么一段时间，需要你自己走，自己扛。	那就自己走自己扛吧
阳台改造的小书房！喜欢吗？#家居#	充分利用空间，真不错。关键窗户的密封要好，不然整天全是土。
34年的时间，同一个地球，环境变化太大了。	希望环保行动遍布全球
喝的很高，现在去OK了。	喝好，唱高，才是最好。
不断的发现以前的自己是个傻逼，这就是人生。	不断的发现以前的自己是个傻逼，这就是人生。
路若走得不够艰难，你就该怀疑它是不是对的。	路若走的太过迷茫莱。？那算什么。
幸福不是对往昔的回忆，幸福是对未来的憧憬。晚安。	没有的爱，找回来。
上Gmail，上到我哭！世间最远的距离，不是生与死，而是404。	淡定，认真想想最远的距离还是生。死。
孩子，你长大了也成熟了，爵爷很欣慰。	欣赏C罗，顺便鄙视一下煤球王
直面烦恼，无畏无惧。烦恼便成云烟。	大师，这个境界不好达到啊
#杭州地铁#线路规划示意图。全部造好，估计2050年了。	上海的交通卡在杭州能用了吗？
下次吃桔子记得剥成这样。	下次吃桔子记得剥成这样
下半场广州恒大能进几个球呢？三个还是五个？	上次5比1仲5够！赢就算啦！留翻D以后慢慢入
牛魔王＂起床看星星咯！早上好大家。出发内蒙	第一个耶。回复下了啦。好姐姐。辛苦了。
Hellokity主题麻将。会不会玩着玩着，就被萌晕过去了？	一点打的欲望都没有。
哪位朋友告诉我，我的上条微博是什么？	如开启了微博智能排序，请改回时间排序，这样就清楚了。
来看看字母表的演化吧，查看大图你就知道viaalink	记得好像有个外国人自费做中国汉字演化的图谱。
听说伦敦开幕式扬我国威八万人唱新加坡歌手的作品了？	这人要不懂幽默了真可怕。所以不被那些人理解你也不要在意。
雨天路滑，小心驾驶。礼让一分，安全十分。#Gif快手#	咋么看都有一点阿炳的感觉，我是打酱油的，别理我
听这首歌你第一个想起了谁？alink	思念是一种病，我好想你。
【趣漫画】“我觉得我飞了起来！”图片来自imgur	果壳同志，你的科学专业捏，我看到这图就笑了
既然非同志，只得配病亡。	还不如现在一个村官贪污的多呢。搞政治就是危险啊！
#520#每天都要开心的过噢！	什么东东。！怎么做的？
汉语拼音之父周有光107岁生日alink	祝老人家生日快乐，诸事吉祥，新年快乐：）
我坚信：关于救市，只要肯救，没有救不起来的……	救做甚？不是还有雄兵千百万吗？
我们可以吵架，但不能影响关系。无论友情还是爱情。	我们可以吵架，但是不能影响感情！
#北京印象#叫声老婆很容易，但是叫声老太婆，却需要一生的时间！	哇、那个年代有辆自行车还是算有钱银的
据说有背景的妖怪都被神仙收走了……#大尸凶歪评西游#	话说我好想忘记了蜘蛛精最后怎么样了
【领袖坐相】蒋介石是坐有坐相，而毛泽东则是显露本性。	这么喜欢自由民主的人为什么不能老百姓自由和民主！
#紫禁美景#海棠花儿开，清香扑鼻。	#故宫光影#春光无限，海棠有情。
貌似手头挺多事情没做没想。管他的，先画画再说。	小飞挺哥们还去为你加油啊
今天终于有太阳啦！完美的一天开始了	昆明依旧在下雨。身体依旧不是很舒服。哈哈
今天突然好想去游泳。「转」	真想变这这萌货儿。
当然有神仙姐姐陪着我在这里：#长沙市区#	河马哥，刚看非你莫属，突然觉得你好可爱！
你不屑一顾的，或许正是他人渴求不得的。	幸福不是努力去爱，而是安心的生活。——转自豆瓣
来，美女，跟我做动作，我做啥，你做啥。	哈哈哈哈……完整版的出现了……
兰小胖在加班，兰精灵们在玩什么吖？	好看，亲，你是服装设计师耶。好棒
噗哈哈哈。这小屁孩，欠收拾！	好可爱的bb啊那重复强调用的真妥当。haha
芦山地震七日祭：我们都是幸存者。	我，打心眼里是这样认为的。感恩之余，应将其化为勤奋做事上。
中国十年蹉跎。老夫须发皆白。	老人家、我十年前就看过你的作品！嘿嘿
单位收到广告信函很正常，可这封……实在太无语了啊啊。	他老人家出来收信怕是要吓死几个人
网友对""哈利波特""的相貌预测。	额额额额。！时间是把杀猪刀。！
中国电信三沙分公司正式挂牌。	祝贺并期待取得更好业绩
酒店走廊发现一幅泰国版≪清明上河图≫	刚好高考完了之后会和同学去泰国…………看清明上河图
良心节目这么久才一次广告…	哪像你的趣多多。慢慢都是广告啊！
今日午餐，依旧自带，小米手机，特殊优待。嘿嘿！	张总用的是IPHONE，纯广告贴！
台湾一篇文章震撼两岸：假如中国没有毛泽东！	WK，是到台湾发展5毛了？还是出口转内销的货色？
原来他还有这爱好。	我仰慕多年的勒夫教练。
你家里有山寨充电器么？	原装充电器配山寨线没事吧，大叔。
不容易啊，终于要面世了！	U3D还是Flash3D？看上去很棒啊
我们华仔累了，做完治疗直接在医务室睡了，真不容易啊	那孩子，怎么累成这样啦
试一试？试一试！alink	小9啊小9，我最爱的小9
每天都被自己帅醒「转」	我审美有问题吗，这不是猿猴进化的中间过程吗
小黄鸭，你肿么了（图via蔡阿吻）	我估计么得时间去看你鸟。最近档期好满。
终于没猜错，这爆踩别人脑袋的官方又宣布为：临时工。	出彩了都是临时工，很牛！正式工就更加的牛了！
当你开始寻找时，那个状态才是意义。——蒋勋《孤独六讲》	不是《生活十讲》吗
18代表梁稳根：共产党员易找对象。alink	他说的难道不是是实话吗
受不了了。小唐尼居然这么骚的表情。「转」	这么热的天买个冰西瓜罩在头上吃才是正经事alink
【地球今日警示】珍爱生命，远离指甲油！	湖南卫视有期节目已经说啦没有这么夸张啦！
据说世界上最动听的话就是这三个字，同感的举个手。	今日又有人同我讲呢句话，我真的瘦了？可惜，我不是呢！
下午出版本啦。全员都在玩。终于像个游戏了。	放眼看去，一个mm都没
看到这货的睡姿，真心很想送一把菊花给它。	看到这货的睡姿，真心很想送一把菊花给它。
在场的不在场的兄弟们谢谢你们在北京有你们真好。	凯丰变胖了。看来还是国内能造福瘦子.
同仁医院血案令人扼腕。制度的缺失陷他们于绝境。	如果制度健全、部门尽责，悲剧或许少一些
QQ和360到底咋地了？！谁能给我解释一下，整地我直迷糊！	萨达姆偷了布什家的高压锅然后怨本拉登
《我这个人儿》我若把我的一切告诉你，你还会喜欢我吗？	······我女朋友也是这样·····
这个创意不好么不好么不好么？为什么不让发呢？	反过来翻译挺不错的。
企业，兴在于人，衰也在于人。	关键是如何管理好人！现在的人不是以前了！
看到这篇日志，我默默流泪。（转）	这辈子最对不起的就是自己的老爸老妈。
有些路，只能一个人走，路上的艰辛，只有自己知道。	不可说，说了也无人可知
麻将这样大才够霸气，太小的不要叫我！	有点意思，让我想起前几天拿麻将机当饭桌还吃过两顿饭呢
我想了半天，我还是决定坚持我闲的蛋疼的风格	上条距这条想了半小时
今天香港媒体是这样报道刘翔的	也许这就是真相呢！
在一起时间长了，长相都变得相似起来。	有句话相爱就会相似
这货不会是下水道的外星人派来监视我的吧。(转)	ληΖдджёxxxx。，给你们发现了。愚蠢的人类。
听说CCTV让失散多年的“姐妹花”相遇了	错了，这是传说中的平行空间
#NBA酷图#三年，他给迈阿密人留下了太多难忘瞬间！	掉鞋光脚投中关键三分那张图都不po上去
麻麻、你不在家，爸爸都是这样带我的。「图转」	这娃儿也挺幸福的！
这道题真心做不来啊！【转】	拿出一个陀螺转转，看停不停
看完电影＜昂山素季＞，真想在电影院再看一遍。	别说电影院，搜狐上有吗？
每次早上醒来，才知道晚上要早点睡。	我对自己最大的谎言就是：今天要早睡，明天要早起。
#GQ年度人物2012#倒计时，现场彩排中，你期待今晚吗	哪个有现场直播的地址发来分享一下啊
深夜赴台北观察选举！机票紧张呀。	那就更不能听他的了。他有什么资格对大陆游客指手画脚。
【实用贴】公务员考试常识40000题，有空看看，增加点知识面	考导游证看的书里面也有这种。
【足球趣图】C罗教你如何一秒钟变厄齐尔。272又躺枪了。	我靠！72不能搞那么多基友没说错吧！
#三国show#这才配得上全军突击的气魄！alink	严重侮辱马超的身高！
#吸血鬼#超级希望他们在剧中能够一起！	希望弟弟跟她在一起
苹果公司到底多有钱？看完图你就知道了……转	有钱，我也赞助了。
这个大一新生好像很牛逼的样子	""我要深入广大群众当众才能了解百姓疾苦。""
深夜毒图！看多了小心感染""爱G病""	这是那辆被笑笑不小心摔坏的哪辆吗？孙大老板
田鼠，笑的好傻好幸福哦。（转）	矮油。怎么这么萌啊。
来了哟！alink，惊喜在这里！	suoyizhizhishuguale？
#Vgirl互动#你曾被说过长得像哪个明星？——po主我是：张惠妹	天心。黄圣依。这两个有差吧，说前者多一些
#妮玛的唠嗑馆#情人节什么的都去死吧！	妮玛不是有王小明吗？安妮同学没有自己的王小明？
我擦。幸好肉够多。（转）	这个饲养员不想混啦？
各种狗血电影的基本套路，一针见血呀。（来自：AlvaroNaddeo）	最后来个蛋，等着拍续集啊
一本引发争议的小学教材，你的看法呢？alink	洗脑式的教育要不得
【图说】正面看《新闻联播》；背面看《微博》。	这主播后面是肿么了？
你十七岁喜欢的那个人怎么样了？	没联系了管他怎样？
野猪居然敢偷吃犀牛的草，简直不要命了！	秒杀？！肚子上硕大颗窟窿
飞天圆梦，圆了谁的梦？	神九起飞，到底完了谁的梦？
决然远市井，卖花大海上。随风自东西，不必辨方向。	听天由命，随遇而安。
欧美男人们的自拍，本人自愧不如。	""INEEDAHOLE，whereisit！？""…
#MotoX发布#一款可以DIY的手机，不过合约价199美元，略贵啊	没有看过，什么手机。
11度！下雨！游泳！好爽！水𥚃比较暖！	哈林哥，你是要准备参加铁人三项吗，金假厉害！
1993年。我追过一粒叫王靖雯的星星。	王靖雯的签名好复杂挖。哪像我们王菲又简洁又潇洒。
今天的风是带凉意的，穿件短袖有点冷，秋天来了。	秋天来了，收割季节到了
上海人知道这是什么吗？	桔红膏，糯米的很好吃。
人生为棋，我愿为卒，行动虽慢，可谁曾见我后退一步。	请问海阳现场秀主题曲叫什么名字，就是开场那个片段。
看到易建联头顶了，啊联的fans不用担心，他很多头发！	看了一身起鸡皮，是感动，是震撼，是无奈·····
这个三年级小男孩写的诗好好啊！「via被抢注的二丫」	把一段话分行写也叫诗？
你们觉得移动电源做成什么样才够酷？	圆形，发光，插胸口上←_←
据说是母亲节最感人的gif图！分享感动。	太感人了，妈妈节到了，祝我的妈妈、所有的妈妈健康幸福！
这样的卫生间。太完美了吧！	哪里完美了，感觉很像恐怖片现场呐o>_<o怕怕
#把乐派给你#据说他家的猫最近很烦躁……	还是把他们家的猫训练成不逮耗子的吧
詹姆斯季后赛得分超越大梦的那一球！alink	拿下这一场后就重新夺回主场优势，热火拼吧
傻子太多，骗子们活的很好，而且都扎堆了。这里是机场书店	成功学===都是做鸡汤的
再彪悍的体重也阻止不了那颗想飞的心	对那颗想飞的心来说，体重神马的全都是浮云
「当你遇到彩虹般绚丽的人」《Flipped》	度娘还我百度账号！
今天是妈妈的生日祝妈妈健康长寿开开心心	祝福。（比你婆婆漂亮）
刚出生的小马，萌翻。	怎么有种恶心的感觉。
10月18日，凡客诚品创业三周年，生日快乐。	昨天刚在凡客买了条瘦瘦的裤子，激励自己减肥…
真正的朝圣之旅，不是向东，也不是向西，而是指向内心。	偏偏是人对各种“风景”的兴趣总大于对内心的兴趣！
【比利时——布鲁塞尔】诗一般的城市。#环球旅行#	喜欢这个城市的天空
好了，新的一天开始了，让我们清空悲伤，好好地面对生活吧。	明年再来，今年就当培养年轻球员了
第一次吃自家制的菠萝炒饭味道真好！	帅哥，不运杆怎么还打得那么稳。
文采如此，何须卖盖饭？	想次遗臭万年之榴莲冰淇凌
分享图片苏伟开了4次撞了3次。保险公司哭去吧。	沙克奥尼伟上路前，请预先发布信息，好让我们都避一避！
短暂的假期结束鸟······	真的好温馨。我也好想回家了
深入揭批百度之第四季：今天转晴，由百度管理层直接道歉	唉！百度花了多少钱啊！
午饭河豚！外表可爱其实巨毒！	曹云金曹云金曹云金
某天早晨，我犯了一个错误，看图就知道了。	蛋壳温度承受不了哦
组颇为深刻而犀利的图，名为——理想在上面，现实在下面。	确实犀利而触碰人心，鼠标要慢慢的滑动哦。
【换个角度来看细节】全景展现延安城管如何打人！	强烈要求政府取消城管这一被全国人民痛恨的部门！
【椰奶捞猕猴豆沙】看到的时候，我震惊了！介个你敢吃吗？	这个长得像新浪，有木有觉得？
表白的就再去看看我的签名吧。呵呵。	抱大腿！拉裤脚！亲妈粉爱你就够了！
这就是男人的友谊！我看了10分钟却沉默了一小时！（转）	男人真的不容易啊，这辈子。为朋友，为兄弟，我认了
早上一直在开会，没有感觉到地震啊？	听说京东要转型了？
承诺，有时候，就是一个骗子说给一个傻子听的。	傻子想骗子骗她一辈子，骗子想傻子能傻一辈子。
很有现代感的客厅，可以在地板上打滚了。	很喜欢，但是这要是打扫起来得多长时间啊？
进入微博大家庭，欢迎多多指教！	坐等双开局长的逆袭。
大盘海鲜，要四五个大男人抬出来！太有气势了！	这、、、这是在哪我要去！
缘起，在人群中，我看见你。缘灭，我看见你，在人群中。	我是天空里的一片云，，
小胖纸。看清点路啊！疼！。	瞧你乐的屁颠屁颠的，这不，摔跟头了吧？该！
满屏都是带着批判精神看春晚的。	现场果然有受不住睡着的呀
善款用作行善，否则就是罪恶！	但是在人民币上是不能写字的啊
【为什么你永远翻译不对这50句英语】【全文】alink	ohio。我艹！这错误！受不了
生菜的正确处理方法，好高端啊（转）	太高端了，回家试试！
总觉得像这样的老房子。时光感格外厚重。容易入睡。	让人有种好熟悉的感觉，好怀念啊。
挨多少骂我都得说，春晚就是TM303，即二百五加三八加二加十三。	十三月强烈要求上春宵
补上一张当时钓上苏眉的一瞬间……虽然表情有点囧	看不惯你这个靠着老子炫富的傻逼！
#WCBA总决赛第一场#信兰成和郭士强也现身了……	不一样的杯子。老大就是不一样。
＂这告诉我们一个什么道理呢？＂	告诉我们阳哥不但睡得晚而且起得早！
跳不了那么高你就别隔人扣了。	还第一次看到失败的
这个点到北京，我只能说无限感动！还好到了。到了就好。	你到北京了？我也在！
所谓“中国学生数学NB”的神话	没仔细看，但是我觉得说的很对
日文贴吧，再见！你的第一个FE会永远记得你。	唉，上线慢也就罢了，连下线都这么慢。
当你不知道如何选择的时候，一定是你自己不了解自己的时候。	当你不知道如何选择的时候，一定是你自己不了解自己的时候--
穿成这样，分明黝黑蜗壳	呵呵，好般配的一对，很喜欢杨老师的解说。
【饮咖啡让女孩乳房变小】···各位女士自己睇着办吧！	真的咩！福音啊。妹子。
#图说#那些神乎其神的气功疗法！	右右两只手都很忙吗？
360搜索出现一周年，我的手越来越犯贱！	我也不自觉的手贱了一下！
原来如此，我懂了。	啊！被骗了二十几年。
有时候我可以看得很淡然，有时候我又执着得有些不堪。	无法淡定。太深爱了
最近爱上了一款新的电脑，叫苹果汁！	苹果过时了，要苹果汁
风飘过，让一切都飘过。	很喜欢这样风格的！漂漂！
你能做出瓦肯人的手势吗？「转」	说简单的，两手掌合一起摁紧了再来分试试。
北京的天啊，像不像电影里的寂静岭，早晚有一天被毒死	这就是很典型的“生活在富裕的坟墓里”
“我最讨厌种族主义者和黑人。”文字链接：alink	现实太复杂了，我看书也许只是为寻找复杂后的简单
#吃货也疯狂#老板，来两鸡蛋……接下去。	傍晚儿，我拿个马达子上门口塞太暖儿
这几天的会，有一块在学习微博。确实厉害。	加州州长候选人惠特曼最害怕的人、阿里巴巴副总裁王帅来了
太刺激了，最后坠地的那一刻真是太华丽了！	第三百秒。日方出动战机拦截了
好狠的设计师……这让人怎么上厕所……	这是要吧人憋死吗？！alink
高考是这个时代赐予穷孩子的一粒精神伟哥	穷孩子们也只能指望这为数不多的梯子了
胜利了！很开心！继续努力	今晚的比赛真的很精彩，继续努力吧！
普通朋友和死党的区别。「转」	有病吧？这样的死党滚吧
alink清华女生铊中毒案19年悬而未破公安部称已结案	上午时凤凰网首页有这条新闻，现在已经撤下了
疼老婆的男人才能干大事，同意的转……	疼男人的女人一定是好女人。
当男女换脸后，笑抽我了！（转）	怎么都是男的变恶心了
每到灾难的时候，总能看到爱，“爱是人心之中的圣灵气息”。	爱人如己，求圣灵充满。
说说你听过最恐怖的一句话！	准备好了吗。我们分手吧。
减肥的首个夜晚，四点钟饿醒，作孽啊。	你需要减肥？不大可能吧
未婚人士只能娶一套房子，这是中国近日出台的新婚姻法。	有钱买二套房的，不会是单身！
胖纸的忧伤，有谁能懂。	猫胖可爱，人胖猪扒。！那些不努力去减肥的猪扒也会哀伤？
早上五点出发刚抵达酒店累惨了	估计今天你是不是到现在还没起床呢！
大家好，这是筷子兄弟的官方微博	我是沙发。欢迎筷子兄弟俩
【揭露美国】奥巴马又调皮了，太喜感。	真的假的？挺帅哒。
这不是宝马，这是永久。	这个广告词好！永久牌自行车
到底因为什么，让你放弃治疗？	打了肉毒杆菌还会反弹，放弃那个人还会想起，除非脑死。==
差距啊！中枪的请默默转发！	小米2s32g的，2a，还有小米盒子，谁要啊
你的手机遇到过自动重启么？	粗粮1s，买来就开始自动重启，直到现在。
两个孩子和他的家长	中间的老爸表示我很幸福，
#郑在路上#途中见一坐轮椅的老人在看报。我也要去买份报纸。	看见的是坐轮椅的老人在看报，为啥选择买报纸而非买轮椅呢？
你今天流的汗和泪，都是你当初选专业时脑子进的水……（转）	尽管因为天冷我没出汗我的泪水都咽进肚子里嘞
长沙的莫鱼们，我来了！你们看酒店很花心思来欢迎我呢！	哇，好可爱好漂亮哦。呵呵。
下面18首歌曲中你会5首，就说明你已经老了。(转)	次奥奥奥奥奥奥奥奥奥我果然老了！
#颜色#有种夏天叫做孔雀蓝！	我最爱的颜色，原来叫孔雀蓝…
哈哈。这车锁的。我很佩服这个人的智商啊看懂了就转	太搞笑了高手还没睡醒呢就上路疲劳驾驶啊
话先搁这，伊拉克不败。国足赢了宵夜我请。	吃火锅，烤肉，烤馒头片
眼瞅着戏曲日渐没落。京剧，您还能撑多久？	京剧的衰落，与文化大革命时代的迫害是有直接关系的
江苏陈光标食品产业股份有限公司招聘：alink	每天用的油盐酱醋都很不放心标哥救救我们
最新款户外跑步机，这个有点意思噢。	总感觉好像很容易摔下来
每次吃草莓，都感觉是在舔一个粉刺黑头鼻。替你吐	真行啊。我以后不敢吃草莓了！
麻麻门在哪里啊，瓦们要出门啦。（欢迎童鞋们添加画外音）	出来哪里啊。来我家吧^^
思考：沉浸在自我表演和自我感动中，这样的企业有前途吗？	是否有前途，他们自己都懂！
【读图】今天还上班的，工资高不到哪去。躺枪否。	咳咳，珈宁，你……
台下风光：香港头号女结他手卢凯彤	头号男结他手咁咪你囖
设计师MariaRubinke的作品，很重口味！	的确重口味手贱了。
昨天晚上做梦我回西安翻译学院了，还住进了南一。	汗，关注你两年了，现在才知道。
在南山上看重庆全景。空气有些混浊看得不是很清楚。	怎么可能？一直晴天。
今天，这图可以出现了.白色的北京.	好可爱啊，是你的形象的卡通版？
有时候，我们看不见前面有什么，却还要一直往前走。。	高中时吧，写过一句是：路，只有走过去，才能回头看。
【侃电影】哪部电影看后，感觉特别压抑？小编先来，《告白》	日本很多电影看了跟告白效果一样
一周动物图片精选。(1:1原尺寸大图1.8MB)	教授的动物系都很精致啊
价值混乱，钱就会变成尺度。——陈丹青《荒废集》晚安。	这不就是现实中中国民众的写照嘛？
敢不敢陪我一辈子，不离不弃！	你若不离不弃，我必生死相依……
爱情，让一切皆有可能⋯⋯	木有食物哪来那么多物质造小兔子啊
""你不能决定太阳几点升起，但可以决定自己几点起床。""早安	你起床了，太阳才升起。
这名片！高端！大气！上档次！（转）	不是吧！国家级大师哦
马上开始，全场坐满，超1300名学生。感受真实的淘宝！	高才生云集啊，马到成功。
算了算了，我看出来了，你们都想看男人！上张美男图。	说明小宣是妇女之友，粉丝都是女生
夜间节目不容易做啊，哈哈哈哈	坚持下去努力下去！我们永远陪伴你
听说王立军是被北京国安带走的，现在踢球的势力这么大啊？	天朝的有关部门真的很特殊，很明朝的东厂西厂一样无所不能
苦难磨炼意志，意志产生希望，希望让我们永不言败，早安！	早安，华夏大地寸草寸木.
听岁月在流逝晚安亲爱的≪IWannaBeFree≫alink	怯怯滴问：可以祝我生日快乐么？
刚和考拉亲密接触，我去。这个臭！	其实考拉也是这么想的，吼吼！
为什么这时候大家才关心到医护人员的前景？	中医很有前景。西医还要三班倒，包括护士。
什么是严谨而认真的工作态度？	精力都花在这些地方了。
【娱乐一下】老湿，这手笔太大啦！	突然想起大学教我们统计学的崔爷爷了。祝他身体安康
寿星发言：我爱大家。大家高喊，我们也爱你。	那个不是郎咸平么？
这个小狗，当时基本是家家都有！有木有啊！	嗯，耳朵被我咬掉了，谢谢
夏天只有吃西瓜和睡觉才是正经事！（转）	说的真对。上班什么的都最讨厌了
科比与乔丹的对比图，喜欢的转。	太用心了，这样都找得出来那么多图片
片刻之间，形势大变了。	原来收到了很多蛋糕
0829话题你们单位都搞过什么工作以外的活动比如春游比赛等	以前在物流公司，举行过驾驶员滚轮胎比赛，拍了照片，挺有意思
靠圃义卖1号T恤！这领口改的不错吧！	你为啥拿那么大件的去呢，也不留件大的给我们
人一切的痛苦，本质上都是对自己的无能的愤怒。	人一切的痛苦，本质上都是对自己的无能的愤怒。
这是我的第一份生日礼物，猜猜谁送的？😜	生日了啊，祝你生日快乐、
用书雕刻的景观byGuy-Laramee#MOMO推荐#	看到了熟悉的广辞苑，果然是日式风格啊
活着，是中国。活法，是中国梦。	有空找我来种种玫瑰吧！就不是梦了。别每天琢磨着换车买豪宅了
我擦！被一只走文艺路线的蚊子咬了。	这蚊子肯定是丘比特派来的
好！有骨气！。（图转）	好！有骨气！我要是老师我也打勾
吃大闸蟹，告诉我你们一口气能吃几只？	那要看蟹肥的程度了。
办了临时的，改签了飞机。	会数钱的朋友们大家一起帮忙找！
拜托，一点都不像好吗，他比较好看…我还是人了个妖去吧…	啊，对了，艾姐跟汤唯都很喜欢介样笑的
天使投资家薛蛮子自办电子杂志-科技频道-和讯网alink	你这贴度娘干嘛呢？
安息吧，来世投胎个好人家。	这么隆重啊好友爱心啊
网络攻城狮的语言和发展方向，你懂得	很像程序猿干的活。
本来用的保温壶坏了，所以我换了个新的！	肿么感觉你家的碗也是天朝特产
别用正在充电的手机接听电话，关爱自己，切记！	手机(⊙o⊙)千真万确变成了收雷
你向上帝借了35秒，却要用一辈子来还。「转」	妈的，，则么那么想哭。
据说这是谷歌眼镜后遗症。（图片来自网络）	才出来几天啊，就已经这样啦。
【今晚买的辣椒一切开，吓我一跳！】	额。anythingispossible
重新开始！发张我小宝哥的照片开心一下。	希望你能越大越好。
哼，谁还没有个想当年！	张震岳小时候的像彭于晏呀。
Twitter网友各种神级恶搞内马尔跳水真相	内球王去巴萨真是实至名归啊！
高考结束的那天晚上，你干了些什么？	喝酒喝酒喝酒不醉不归……
人生中10件无能为力的事。	有时候，一个人的牺牲是为了成全另一个人
穷人专用花，还没送的赶紧收花！	好实惠哟。要是有人送我，我也不反对哈哈
加班后酣睡的花样美男，天然骚。	老罗今晚去李志的演出么，有登台献唱的计划么
《海扁王2》Kick-Ass2召集原班主演，锁定R级，2013.6.28北美上映。	超杀女会不会换人？箩莉变美女了
人类已经不能阻止他卖萌了。	太可爱了！对卖萌的宝宝没有免疫力
微信怎么了，大家能发么？	发不了了能说粗话吗？我去年买了个表！
这一集国家地理屌爆了。	这个故事我也听说好，相当的无厘头
有时候，夜深人静，突然觉得不是睡不着，而是固执地不想睡。	我不是一个人在战斗！继续熬夜。
清晨走在这样的小路上，该是多么美妙！	个人赶脚傍晚的感觉也许更美好
原来这样可以拯救地球的，再也不用担心2012了。	妈妈再也不用担心我的学习了
老汉这手艺还行不？红汤肥肠面。	太腐败了，还有虫草！
一杯够一家人喝了！哈哈哈哈好狠的mojito。	介个实惠！夏天整一杯。
你绝对无法想象，把曼妥思扔到啤酒里，会有什么样的结果。	吓坏脑汁了。最后这人死了吗？
幸福就是，虽然上课没听，但发现听的人都没听懂。	这是大学生上课经典名言？
最近超爱红色，可能与我的心情有关	不会又有喜事儿吧。
你常一个人看电影吗？	把最后的表情去掉，孤单是一个人的狂欢
中国简史——果然够简（看完我笑晕了）【全文】alink	中国简史，O(∩_∩)O哈哈哈。
你们真是够了！秀恩爱什么的最讨厌了！（图-9gag）	哟。黄小喵，一脸淡定，gj
埃及街头活动者举牌：“埃及人民授权军队铲除恐怖主义”。	这个……中英阿拉伯文对照吗？
女士们都在抢花。蛋糕都顾不上吃了。	鲜花与蛋糕同上，美女与野兽共享。
舌尖上的记忆——怀念80后的六一儿童节。「图转」	现在都哪找到的这些？
【华夏姓氏图腾】快来看看你的家徽是怎样的。（转）	看不懂啊貌似看到一只炼丹炉。
#百度开发者大会#现场度娘来袭你们觉得呢？	怎么有个像练健美的呢
呵哈哈哈哈哈哈哈哈…我圆满了。	赶紧撮合啊···撮合失败就鄙视你啊。
讨论贴，关于「幸存者马云」。	中国局域网导致外国的网站在中国不成功
深夜话题：给你5万、50万、500万，你会分别怎么创业？（知乎）	不早了该睡了，也到了做梦的时候了啊
【励志贴】岁月有时候也不是一把杀猪刀，而是大力回春丸。	只有力宏是真材实料！
一把年纪了干活还得解一个二元二次方程组，做投资容易么	向你致敬，我已经不会解了
最不幸的事情是什么？最幸福的事情又是什么？	知不幸为最大幸，不知幸为最不幸。
故事：香港政客【全文】alink	从小看无线六点半新闻长大的表示，故事很形象
4月17日晚8点，小规模上新哈。alink	没有名字。第五排的右一是什么呀？
#米聊发图#长见识了，什么叫空调的一机两用（转）	不好！没隐私感！做爱隔壁都听得见
头一次见“国家开放大学”。	你没说到底开放不啊
曼城怎么搞的，孙继海不是状态不错吗，为什么不让首发呢？	已经在热身了。一不小心拉伤了腿！伤退了。
自由不是你想干什么就干什么！而是你不想干什么就不干什么！	话里有话，觉得很深奥，在说谁呀？
好像是大钟寺爱家收藏着火了，里面无数宝贝要遭殃了	是旁边的一个宾馆！火很大！
我喜欢下雨天开着车在城市里逛来逛去，一个人也不找。	天黑了，快点回家睡觉吧
今晚再望月：仍是儿时月，却无少年心。	愿君常忆儿时月，愿君常怀少年心！
生命中最大的课题——坚强。	生命中最大的课题——坚强。
最近北京老是下雪，都已经没有兴趣拍雪景了	看广州等下雨吧……
左边是原产图标右边是老罗团队画的	饿就这样的东西？以前上vi课的时候资料一大把
南都这个亿像素太牛逼了！alink	确实很清晰南都不怕玩大了？
字名人2＜未完待续＞（最后一个简直丧心病狂）（via王中左右）	只有杨幂的名字看不懂，怎么来的？
时光带走了那个凶巴巴的她……（via：热带猫顾顾）	好写实啊现在过马路我先拉我娘的手，怕她反应太慢
“浣碧，扶我下床走走接接地气。”“小主，这里是15楼。”	于是浣碧开窗把小主推了下去
如意……还是系统自动发送alink	如意洗湿了变好小只啊！今天是集体洗澡日？
弘一法师书法---“了世皆如梦，见心无所生”	弘一的字，宛然“心无挂碍”
做不生气的妈妈（via:柏柏BJ的亲子漫画）	妈妈真是世界上最难得工作啊！
什么都不想说，却什么都敢想。	什么都不敢吃却什么都爱吃
好基友一被子。2013.4.20八点左右。莫名感动（吴夕沫）	有心情拿地震开玩笑，你们也笑得出来？
混蛋！放开我的绿萝！	都瘦成骨架了还不让人啃点绿萝妈蛋！摔！
显微镜下的沙子是这样的。	确实，一沙一世界。
北京天气原因无法降落飞机安全降落石家庄向河北人民问好。	来任丘吧任丘没打雷也没有下雨
如果把（西游记）逆向思维…这TMD绝对是一部神作！「转」	这就不是西游记了，而是东游记了。一路向东
求推荐老年人用的app小游戏。我爸以前只会玩pc上的连连看和纸牌	象棋！外公为了下象棋才买的iPad
短信必遭淘汰，立此为证！	说的是废话。手机也必被淘汰。一百年后。
1分钟后竟然爆炸了。太惨了。	哈哈哈2秒后才反应过来哈哈哈哈哈
【搞笑图片】谁说中国木有原创！	拖鞋里的战斗机，哦吔！
应该为此女记上特等功！	6人片长终于突破一分钟！
你毁了我容忍傻逼的能力。——《生活大爆炸》	你让我想起满洲里法院宣传栏里的两朵菊花。
发组最适合北京当前环境的作品.<尘浮.世>	现在看，你好超前啊。太高瞻远瞩了
糗事百科出书喽。5.2折，赶快入手吧alink	应该给糗友们稿费或补偿。
你不懂我的沉默，又怎么会懂我的难过。	不懂我的沉默，又怎会懂我的难过。
有人说“甘肃校车事故被通稿”是造谣。好吧，截个图。	善后工作也要不惜一切代价？
端午节3天假，没钱！没安排！没人陪的转！	有节目，木有钱钱。
世界上最幸福的事，莫过于有个人总是会逗你开心。	那蜜蜂衣我家狗狗也穿过。
今晚来到了南京。朋友介绍了一位好大夫。	我也在南京，你明天还在吗？
土耳其航空的飞机餐。真是烤肉么	竟有这事，我不相信！
今天北京街头惊现。车！没见过！	不会是曾经走过京开高速吧？
复仇者女联盟！外国网友的PS作品，太赞了。！「转」	蝙蝠侠是复仇者联盟？
越狱第一季；越狱第二季；越狱第三季；越狱第四季；完！	越挫越勇的小家伙太可爱了
在上海无睡意谁醒了来找我聊聊天alink	谁在我附近？一起早茶去！
#马刺vs湖人季后赛对决#魔兽和邓肯的上半场数据对比。	不看了睡觉，明天看结果！外面还下起雨
一个圆可以画出很多动物，非常可爱哟。(源自网络)	稀饭…以后日记又多一些小动物了
云南抗旱行这些桶里装的是这一家人三天的生活用水和饮用水	看到榜样的力量，大家心里会更安心
上半场结束，国安目前0-0。	某前锋完全没有预判跑位，速度还没有对手后卫转身加回追速度快
同样是siri差别怎么就这么大呢，养你有什么用	它这是间接暗示你，不如搂在一起睡会儿吧
每年，至少要去一个从没去过的地方。	IwanttogotoYunnanprovincein2013.
如果雍正那会儿有QQ，那《甄嬛传》里边的人……(via:-小俏妞-)	如果雍正那会儿有QQ，那《甄嬛传》里边的人……
理工男玩千手观音，应该是这个范儿。(果壳网)	这个是日本的那个什么组合么
好的照片是不需要ps的……	位置是创意的根源，二师兄，哈哈。
据说是阿哈尔捷金马，也就是汉朝的汗血宝马，身材真好。	我爱上了一匹汗血宝马，可是我没有马场也没有钱。
大丧失！太狗血了。图侵删.	这个。掉节操的问句，床上咋办。
上海第二顿，新荣记野生大黄鱼，鲜！	要么带套，要么大肚。
每天，照进房子里的第一束阳光唤我起床！	呵呵！房间布局风格我都很习喜欢，早安！
发些去年的照片，怀旧一下。谁要养小狗这鞋正好当窝。	要养chiwawa才行吧··
还有什么比这更悲剧的吗？	不能找会上网的丈母娘
生活，一半是回忆，一半是继续。	真的是一半是回忆，一半是继续，我真的在回忆中，又在继续中
当一个老外迷上麻将以后。	民族的也是世界的！
【元宵晚会现场图片3】廖昌永、蔡明演唱《因为爱情》。	这究竟是混搭还是恶搞呢？晚上看了再说吧
动物刚生出来的样子，你肯定是没见过！	你个小王八蛋，鳖孙的。
不管对与错，它都是你生命中重要的一刻。安。	珍惜不能复制的每一刻
神技能！看一遍笑一遍！哈哈哈哈哈哈哈「via酱婶儿」	这是假的吧？不过眼神太到位了
一张表揭开FGW油价之谜！	曲线救国啊，这个游戏玩的好
北邮的厕所，尽显IT奢华。	北邮的兄弟有木有？
明晚一起High爆济南奥体西柳体育场，全场来个重口味	哈哈哈。明天就可以见他了呢。我在济南哦
2014年备考复习时间表，大家可以仔细看看借鉴参考一下	接力棒又到了我们手里。
据说这是拆不散的夫妻标准。不管你信不信，我反正是信了！	很长不过我坚持看完啦
【春晚精彩图片】节目看点之三：一套精彩绝伦的动作表演	哈哈，这个节目太好笑了。支持大家新年快乐，平平安安，身体健康
明早七点半，魔术vs尼克斯。新浪视频咱接着聊:)	云队，你支持哪边？我支持卡特！。
我在地坛书市。真是一片知识的海洋啊！alink	昨天去的，在三联那挤了好长时间！不过收获颇丰。
速度向荒漠延伸——罕见的越野跑车LocalMotorsRallyFighter。	移情别爱到此车啊。！
遇到这种傻逼我只能这么回他！	我越来越中意小互你啦
为了庆祝月全食，我要连吃一个月各种好吃的！	亲王开心不是日食，一日一食……
吟罢低眉无写处，月光如水照缁衣。（鲁迅）	啊喂！这个配图也太微妙了一点吧！
商场里那件不买会死的衣服，穿回家后才发现不过如此。	任何东西包括人都是如此
我认为这是年度最牛逼的段子，没有之一。「转」	也不要当着绝经期老婊子的面说流量。
这款耳机也太拉风了点吧	可这照片里的人也太挫了吧！
不许动，你已经被包围了！把你嘴里的骨头放下！	哎哟。！你们吓到它了好吗！
你好，八月！希望这个月过的好一点！	一切都快点儿过去吧
要飞了，一会见童鞋们	估计要停，打雷啦！暴雨啦！你下来吧！
3.8节，男人和女人的一天……中枪的转。	为了安抚伤心的男同胞，3.9和3.10连续放假两天。
#电影#《狩猎》，不该低估任何一个谎言潜藏的杀伤力。	最近比较关注麦德斯米克尔森，主要是因为新的汉尼拔
晚会马上开始，现场沸腾了！#阿里巴巴集体婚礼#	我看到我师父李龙璋和大龙嫂了！为他们开心！
一只苍蝇都能飞到29楼…你又有什么理由不努力呢！「转」	这是一个拼电梯的时代
据说，现在普通单位和文艺单位都放假了。	2*单位啊。年终奖还木有发。
我圆脸肉多，无聊了还可以揉揉。	我肚子肉，无聊了还可以拍拍。
【北京6岁孩子的幼升小简历让全中国人民不寒而栗！】……	传说中的“郑志学”跳出来了？
一觉醒来大不一样呢。大家，早。	早早早乐观向上的人儿
芙蓉姐姐：今晚看了新闻联播，一如既往的景象「和谐大中国」。	快下台了。这么多暴民。
是时候和朋友面对面了。#微信4.2视频通话版#alink	不好用了，更新后一直在加载，求解释
菠萝啤这种东西，是不是很多人都不知道？	知道且喝过，灰常好喝！
某网友：据说这是iPhone5掉漆真相！	这个漆完全可以掉。掉的很好
不是僵尸粉的话，都来评论下？	来吧来吧。评论下做饭去了！
看完这个视频我楞了一秒钟，结果却笑了我五分钟alink	我就在电话上看，哈哈！
芊墨。浅浅，淡淡，遇见有缘的人。	你是最棒的。！加油。！喜欢你。！
出了，还是免费的…不说了，看图懂了的赶快…alink	这张图片是……哈瓦那和哈特狂暴二人组要出来了啊！
春节谁在三亚？求伙伴N枚！	呦，又相聚三亚啊。
贵国为什么如此热衷抢尸体的游戏？真是奇怪。	活人会说谎，但死人不会。
太贴切了！下午四点办公室的N种状态。你属于哪一种？	有这功夫还不如翘班出去打麻将
最疼我的男人我真的很爱你。（via小凤凤的小图图）	做老豆心中的：不愧是俺女鹅！
全体网民公投:立即废除计划生育政策！	生育权是基本人权，人权岂容政权横加剥夺！
对于这件事，我转发，不评论！	这是作秀给友邦看么
【中国瓷】纤纤捧，冰瓷莹玉，金缕鹧鸪斑。	在网上看到的，还特地买了一块的说，瓷器真心好看
考试的时候，你若侧身，便是晴天。	哈哈哈。很熟悉的动作'
天大的烦恼，也要勇敢面对。	【烦恼皆自寻，无心一世轻】
如果不允许电视台重播任何节目，结果会怎样？	结果是电影频道有新电影看喽
两个本命年过去了，言尤在耳，人已凋零。	噩梦还没醒…………………………………………
重温而不仅仅是感恩。而是要继续向前走。	论坛就一个晚上吗？明天还有吗？
放假去哪玩？健康，惬意，新鲜的空气——雷霆崖欢迎你	我不是牛头银、俺是血精灵、老家银月城！
一生中你唯一需要回头的时候，是为了看自己到底走了多远。	回头，需要么，看一下走过的距离不会长也不会短……
发错发错。是北京工业大学。	哈哈，你也太可爱了吧
「不同工种的人入睡姿势参考」为什么没有作家呢？🛀	每次睡觉都会把头藏起来，所以我是骑士？
你猜你猜你猜猜猜！	哎耀。！变国字脸了！好正宗啊！
过年都吃的比较油腻，来点儿清淡的吧：嫩豌豆配茶油浸鸡枞。	鸡枞还清淡。蘑菇，好贵的
你那里下的雪吗？我这里下的落叶	你哪里下的雪吗？我这里下的阳光
你找到笑点了吗？反正我笑了。	邪恶的标题党，悲剧了那些灌水的
任何一件事情，只要心甘情愿，总是能够变得简单。----《彼岸花》	只要肯花心思什么复杂的事情都会变得简单化
北京首都高老庄国际机场。二师兄来了！	这名字取得也太有才了吧
#微软广东分公司乔迁太古汇#微软(中国)广东分公司员工的一天。	港汇啥时候有这条件啊
新的百家姓排名，看看你的姓排第几位了？	俺们家族计划生育工作没执行到位，邓峰了
萝莉Mackenzie-Foy，《暮光之城4》中扮演爱德华与贝拉的女儿Renesmee！	分享+1更多热门微博：alink
女生最讨厌男生几大装扮，你中了几枪？（转）	混在一起的才叫傻逼
中超演播室偶遇当年国安后场铁闸	为什么直播时候你的眼睛，跟你照片里面的眼睛，这么不一致。
梦里出现的人，醒来时就该去见他，生活就是那么简单。	说的好，楼主不知道什么叫托梦嘛？你去找TA吧
WJ牌照路虎揽胜运动版，就好像是一面镜子。	别吵了，你不把它喂好了咬自己一口怎么办？
你怎么看东莞奖励见义勇为老外5万元？alink	如果是国人见义勇为又被殴打了还能有这种待遇么
所谓大学者，乃出大官之谓也！－－有感于清华百年庆典	原来是祝福，现在是恶心。
朋友送你这个iPhoneCase，你敢带出街么？	怎么装？随身携带都困难
就算你是一个仙人掌，我也愿意忍受所有的疼痛来拥抱你。	有的女人天生性感。
我们觉得，这样的帖子不应该只发在内网。	和名人做小伙伴，压力好大呀
发展过程。节操碎一地啊，美女，敢问你舌头能收回去吗？	他样子太爽喇，太可爱了吧！
你要，象少年一样热烈地爱，象老人一样平静地痛。	你怎么说的这么准确！
你猜，伊瓜因是想射呢？还是想传？	“伊瓜因是前锋是射手所以他这一脚是灵光闪现”
风静了，雨停了，刘翔回来了！	12'97刷新纪录，祝福刘翔！
任务管理器居然都能玩成这样！这不科学alink	仔细一看，英特尔酷睿i7。
【一图看懂美国财政悬崖】alink（腾讯财经）	米国债市折了，咱的复兴大业就算成了吧，昂？
“这张图不管从哪个角度看，枪口始终都是朝向你。”	废话，这是图片，难道你能看到侧面？
暧昧都不持久，互不搭理才是永恒的。	或许这么说，暧昧只是需求，互不搭理才是返璞归真
詹姆斯这突破居然是进攻犯规！裁判？呵呵。	克劳福德火线出场？裁判不甘寂寞啊。
小猫猫，为甚么你不爱我	它公的吧。羡慕嫉妒恨吧
你可以走出房子，但你总要回家。――WitoldRybezynski	走去哪里都得回到这里…心居住的地方！
吐舌头卖萌什么的。你怎么比得过他们？。alink	第三张图里的狗狗是什么品种啊？好可爱
最近状态很不好，我怀疑自己得了抑郁症。	真幸福那。一疑似抑郁。这么多人哄着。
为五四青年节做一福利广告（注：转帖）	不是wifi么？难道这些年我都眼花呢？
很有爱的情侣头像，无水印版哦。喜欢就转走吧！	呼呼，敢不敢陪我一起用哦
擦，什么？女生DOTA笔记。次奥！	很好的微博哥最支持你了
有多少人喜欢吃烤韭菜？	烤韭菜，金针菇，茄子，西兰花，都好好吃啊！
金牛又来了！但愿圣地的金牛能给大家带来吉祥和阳刚！	有水平接地气佩服。
牛人超节约室内空间创意设计，广大蜗居人士必看alink	神！求你！可不可以不要这样啊！大爱呐！
#微热议#弓长惠女未又变成张惠妹了。(图片来自网络)	阿妹。乃是肿么一秒回归张惠妹的。
沉默=避免许多麻烦的方法。微笑=解决许多问题的方法。	学会沉默，学会微笑
粗不去了，快来帮下忙呀。「转」	又是一个卖萌的胖墩
愚昧就是不知道在自然的经验范围之外，还有别的可能性。	大炮好久没上微薄哦
11年前此时的新浪新闻中心首页	貌似我参加过，当年还在万泉庄小学侧楼
今天晚上怎么了，就是睡不着。	每个月就有那么个日子睡不着
315结束了，明天有两件事：停止供暖，实名认证。	听日唔单止把声哑咗，只手都跛埋，拜拜先啦！
金球奖上最落寞的大叔	tommyleejones为什么是这个表情。
哎呀呀！14分钟，厄齐尔的射门偏出！	三个单刀不进小心报应==
刷了好几个小时的手机刷机刷到手抽筋了大家看看能认出几个？	从上往下第五个是小米
再不减肥，你也可能会是这样的。「转」	他身上的豹纹。密集恐惧症啊啊
一句简单的话，多少人不在意啊。请保持车距。	去晚了。在泰华城未见大师，实在失望
#WeAreTheChampion#军功章有我的一半，也有你的一半#迈阿密热火#	都是一帮史诗级的伟大球员！
三国杀各大佬们的本职工作其实是。	哈哈哈哈哈三国杀真相原来是这样的
名字里“轩”的朋友们，你们躺着中枪了。	公众人物，有点不太好吧
奋战结果，今天继续，期待今晚的双十一，求包养，求免单。	多买两瓶啊，下个月去杭州正好喝
汉字太厉害了，看了好久，我承认我中枪了。	啊、、、我才发现啊、。
JUMP八位漫画家画风的「绫波の笑颜」。(富奸笑死我了alink	富奸就是一拉仇恨的。
不行了！这眼神实在是太帅气了！alink	牛哥真是……太。帅。了。！赞！
刚让小米语音助手给我讲了个笑话，然后。alink	呵呵我的投诉没人处理是吧
北京出了道彩虹，微博里刷得跟过年似的。	直导，出彩虹比过年新鲜啊！
新歌录鼓於录音室，鼓手小白、我与家栋老师。	自动转入脑残粉期待模式…
失望只有两种可能：选错了人，或是怀有不该有的期待。	我看成了：选错了人和怀错了娃。
人生总是很累的，你现在不累，以后就会更累。	胖子总是很胖的，你现在不胖，以后就会更胖
你就是伟大的狮子王！辛巴！「转」	孩纸，那只喵是辛巴，那你不就是那只狒狒。
我最爱看女人讨论智商问题了。	不怕公子废了你么好大
生时书柜放书，死时书柜放你。（设计师WilliamWarren）	最后发现，你输了……
粑粑，我是从哪来的，最新版，嘻嘻	。他要悲催到什么时候。是英镑还是美元？韩元。
WCFGame2西决第二场，拿下。	8分钟得2分，不玩心跳会死嘛！
朋友们早上好，今天空气质量。	早晨！Youarelatetodaysinceit'snotanineday？
时间不会让我忘记你，只会习惯没有你。——《小语》	貌似自欺欺人，若是习惯没有了，也就已经忘记了
【2012011】永浩中国第一鸟（网络名人一）	超级无聊，还佳作呢。这不吃饱了撑着嘛！
作家崔成浩上广州日报啦	小崔比想像的帅多了，长得太像朝鲜人了
上半时比赛结束，场上比分，本尤德科0—0北京国安。	破菜地，这要是回主场还不给他们Y制造个血案吖
强迫症的最高境界，比如去超市看到。	太夸张，我只想把它弄的更乱
银魂国语配音第1集alink	听着听着.我眼泪流了下来
在国内，你最希望能早日普及的技术是？	翻了一下评论，最受期待的是翻墙术-_-
从小到大，你一直喜欢的欧美男演员是__________。	哈利波特丹尼尔！即使他长大了不高，但我还是很喜欢他！
选一种姿态、让自己活得无可替代。	选一种姿态，让自己活得无可替代。
超创意的poping，只是数学老师看完哭了。alink	以后数学都这么教，看谁还能不及格。
汪尼玛倾情COS铁血战士！	多特么疼啊你怎么不特么cos呢
这表白。霸气中带着一点小清新。	好温馨的表达方式，不过我真的就认识那几个字……
一想到再过60亿年地球就要毁灭，不仅悲从中来，早安！	那时候咱们早变成外星人了
据说大黄鸭要来北京了，于是……	全聚德是什么玩意？
国内著名营养专家建议国民:早晨不要空腹吃喝。	擦！不吃喝那还干什么啊，这营养学家NC啊，难道用舔？
今天被雨困在家里，免上班！	你还真好来，休息啦！
美的令人窒息的门口装饰。	这需要心情。也需要情趣！
你幸福吗？此时此刻，一个人喝茶，也没什么好想的，算幸福吗？	你认左契爷就幸福了…傻嗨
乱弹之--全球各大品牌logo色彩分类图	这个猛，看看你得品牌色系
一切问题，最终都是时间问题；一切烦恼，其实都是自寻烦恼。	入定去，该休该眠了。
网易体育都能把专题做成这样，果然有态度：alink	内容为王张朝阳你去死吧
一个能感动数亿父亲母亲的瞬间。	好假吧孩子应该是倒着的，好假好假
这就是脱离群众的下场。手机怕是很难找回了。（转）	叫你和群众打成一片看现在被群众打成一片一片了吧
#看图猜电影#这是哪部电影？（ps：当时她只有14岁）	初吻不说14岁还真忘了。
在上海的北京朋友们，你们还好吗？	什么意思？北京今晚雾蒙蒙的
奢侈品与公款消费联系如此紧密？	平常老百姓谁能买得起奢侈品
若经济条件允许，您是否会选择送子女出国留学？alink	不会！直接移民……
早上醒来，街上锣鼓声，此刻此镇。	贾导；从结婚后回汾阳了没？汾阳人民想念你！
百度官方微博即将上线，敬请期待！	即将？那这是什么。。
这张Passbook有人看得懂没？alink	Oceanic让我想到了lost不错有机会重新看一遍
求高人指点，今年的猎头市场和2012年比，会可能有那些不同呢？	更残酷，变化更快速
封闭开了15小时会，又看片又互拍砖，桌面一片狼籍	继续，我喜欢，越乱越好，这是个人意见伟大的碰撞
转一个日本人对中国的看法	骂的好，字字诛心，说的都是重点
听说我今年会出写真	你是不是很我家老刘一起去的说！
信任就像一张纸，皱了，即使抚平，也恢复不了原样了…	信任就像一张纸，皱了，即使抚平了，也恢复不了原样
大家早！小米手机x2=816，798。今天你会来吗？	狠想去，没票，林总给个机会吧
【今天是个好日子】你们懂的…	恭喜狼哥狼嫂，撒花
Nike+显示我刚刚跑了11.0公里，速度为7'26""/公里。#nikeplus#	潘总，您最后跑完那一刹那是满足还是想在坚持一下。
早上好！周五的早晨总是感觉格外的美好有木有！	木有！因为我和你一样要加班！
乔布斯耗时35年种下的苹果树	有乔帮主的苹果才是真正的苹果
三个月脑袋睡扁，还能圆回来么？	能。多注意些吧，以后。经常的给孩子纠正，不晚。
捕鱼捕到一半居然睡着了。。	抓鱼可是力气活啊，哎呀妈呀累死为了。
终于想起李天一长得像谁了！（via验算纸）	我擦。毫无违和感。
别说我什么都没教过你	小苹果，快到我碗里来，我是起床困难户。
婚姻：是选合适的，还是相爱的？（转）#情感智慧#	无需为他人停下脚步，唔值得！
每天早上都要面对的虐心故事	虽然没有这种困扰，看了依然觉得好虐TT
澳大利亚亿万富翁重建“泰坦尼克号”，亮瞎了都！	泰坦尼克号可以重建，爱情却无法再来一次。
233外国网友的黑暗料理·彩虹果冻（alink）	这真的不是食人花吗
【最新全球排名前50网站前端开发语言统计】	说真的py确实是个好东西
100年后的iPhone，你会买吗？	要真的是这样一定会买哈哈哈哈
据说，爱笑的人智商都比较低，你想到了谁？	为毛我想到了zijiq
地铁里遇见他们，你会是什么心情？3--4个字表达。	你们一起多少钱一晚？
#没品新闻#见过那么多为音乐而生的，第一次见到为音乐而死的。	用生命在唱歌的男子
十三月唱片正宗原版的《狐狸》——万晓利alink	原版的狐狸，支持独立音乐。
alink将进酒之中科院博导版。怕是李白当年也不过如此吧	老夫聊发少年狂啊。
在路边喝了碗花生汤。这会不会把城管给招来？	厦门的天气还这么热？
某网友在大英图书馆门前拍的，的确是个问题。	莎翁看过后也会微笑。
今天中午惨绝人寰的聚餐场面。	明显买的不够嘛。你看都不够吃的
让我慢慢忘记你！像朝露蒸发阳光地	让我渐渐淡漠你，像时间错失了流年。
韩红的气场太强大了！娱乐精神超过那英。	看的越多中国梦之声，越是期待快男啊
请爱护你身边的胖子，因为每个胖子都是潜力股。	请爱惜你身边的女胖子，因为芙蓉姐姐就是个典型。
九华山下次见，合肥我来啦。	晚上见咯，期待你好听的音乐
凡客手机客户端每天下单量超过万单没？	借宝地问问淘宝手机客户端每天下单量是多少？
这是一本杜蕾斯性爱圣经（图片来自网络）	这是一本在中国生存的生活指南
自己下厨：五花肉烧甲鱼、苦瓜炒蛋，自我感觉水平上升！	五花肉配甲鱼，很有创意
坏消息：腮帮、MM和鸟人都已4犯了目前比分：热火56:68	27连胜的热火快回来！
吃了一块月饼，估计登陆月球之前不会饿了。	哈哈，亲爱的，早安。
用屁股吊起一个人原来屁股这么结实。#GIF#(2.8MB)	为什么不两边对称夹呢…这样大概会…疼轻点？
【动态图】永动机的机械原理。也是宿命里跳不出的轮回。	汝若全德，必忠必直；汝若全行，必方必正终身如此，可谓君子
猜猜黄健翔今天跟我说什么呢？	我有许多小秘密，就不告诉你哈哈就不告诉你。
呀！大后天的大后天的大后天的明天就是国庆了啊！	大后天的大后天的大后天的明天。
还原电影中的真实场景，尼玛！这钱省老了去了。「转」	幼小的心灵这就样被伤害了
我们走得太远，以至于忘了，一开始是为什么上路。——《复生》	是呀，我们都忘了，生活中剩下的似乎只有繁杂和无奈。
纽约留学女吐槽富二代小白领alink	虽然肢体动作夸张了点，但她说的话却符合现时的社会风气。
三八节愿望：请老天赐我一个哑巴大吊哥！	卤煮真的不是在说张起灵？
如果是我，我八成也会被吓个半死。——9GAG	我怎么看了一直笑〜
英国插画师AndyWard设计了这一系列萌呆的动物插画海报	好想看他们的动画片，那故事肯定也很赞
货币的命运最终也将成为国家的命运。	还是考虑货5的命运吧
我才不信只有我一个人这样！	我可不是，总会留下一点没有清理，哈哈
柏林阳光真好，酒店房间是我梦想中的写作房诶	又去哪里鬼混去了？
死猴子，放开我。伦家害怕。（转）	充分说明：潜能，都是被逼出来的。😏
等待领导接见，姚明在跟旁边的嘉宾聊天	怎么申请认证四天了还没有半点反映啊
很有意思的一张图：有时候，眼见未必是现实。「图转」	窥一斑可知全貌，是断章取义也。
天底下真的有很病态的教练。----------#朱德庸帮你看奥运#	这是一个深谙运动员心理的男教练！
人好看又没有口音，是一种美德。	Exactly。好看甚至其次。
热火三巨头最左毫无痕迹。	嗯，LarryBird也到我大迈阿密了么？
各位童鞋晚安，偶先睡了，明天又要上班鸟！	这叫还要补作业的我情何以堪
裤子都脱了，你这是在逗我吗？(转)	这是要出啊？还是要进啊？
#iPhone5发布#iOS6正式版9月19日更新。	恩这个还可以.毕竟机器也就这样了。
超萌松鼠，竭尽全力打捞落水坚果……好护食的小吃货！	有点像《冰河世纪》的那只。
介特么不科学！介泥马忒可乐！	沈爷就是型男高富帅无误阿！
贵族猫的物种起源。	揍你个biang的，让你贵族
第一天复工，第一个到的办公室。	办公的地方小点了！
发现把绝世好牌，敢问这牌听哪几门？	哇靠，是童子都能啊。
小编，注意你的节操啊。	我好怕怕，好怕家洗牙哦
一个人捅死了6头狮子！这是人类中的超级塞亚人吗？	忽然觉得武松弱爆了
在顺德滴第一天早晨开始了，真美好	完全木有顺德气息啊
一个细节：新华社竟然没有薄熙来会见哈珀的照片，微博竟然有。	新媒体将会弱化旧媒体（注意不是取代哦···）
请问，这货是怎么上去的。	神龙大侠家表弟，虽然不熊，但都是猫。
老虎赞不绝口，小关着实火了。	只想问下为什么在优酷里有大约10多集晓说已经搜不到了。
这些心思巧妙的发明，你最喜欢哪个。	都喜欢！都是奇思妙想啊
刚刚小速在360百科搜索“回眸一笑”，瞬间哭了。	360这流氓再打广告也没人用
你对下一代iPhone有什么期待？	像黑莓一样的LED提示灯
海边堆砂器，美丽总被涌潮水拍风吹去。堆过看过，平静就好	如果配个图更完美！嘿嘿。
李老师的新座驾终于出炉了	很帅嘛！喜欢红色。不过李老师要注意安全哦
卧槽，第一眼还真没分清头是谁的。	我看了十几秒才看出来。
易中天在动车事故头七改写的歌词，同车的你.	同车的你，我们都是幸存者！
岂止是坑爹！简直就是坑爹啊！	敢不敢集体给取消关注让他掉回零！
眼影的李敏镐。喜欢的转起来	我喜欢眼线男张根硕
说不上喜欢你什么但我肯定你就是我喜欢不上别人的理由	你就是我喜欢不上别人的理由
冲上云宵执信版预祝母校九十周年庆典圆满成功！	点解你地唔胶头，胸卡又唔整齐呢
【试试你的眼力】你用多久能找到8	找了好久没找到，眼花了不找了
QQ隐身，到底是不想跟别人说话，还是不想别人跟自己说话？	往往是想跟某个特定的人聊天
【苏格兰DunnottarCastle】城堡里藏着寂寞，寂寞在唱歌。	你听，寂寞在唱歌。
有时候不是对方忽略了你，而是你太闲了。	好像有那么点道理……
说这是广西最牛汽车……不小心碰上了广西最牛交警。-	额滴神呀，难不成是被撞习惯了。
独卧峡谷中，满目乱山横。云飞去何处，且来听大风。	天寒地冻风萧，峭壁陡崖坡斜。云绻云缦轻逸，独卧沉默寡言。
二手家具商的创意广告：用价格换瑕疵。	也算是明码标价了，Goodidea！
人生，就是一次吃撑接着另一次吃撑。#记一件有意义的事#	猪生也是，苍蝇生也是
暴走漫画6月神秘活动，敬请关注。	看谁上的小学生比较多？
再乱买零食就剁手，先从不拦着我的人开始！	我拦你了，不要剁我，（从不吃零食）
#NBA酷图#这位英雄，你这是要？	哦吧港南style的前奏……
1分08秒，“志玲”姐姐又欢乐躺枪了！alink	没的看，就看预告片吧！
这个发色莫名觉得有些sexy。	这个颜色做了头发就算报废了
男子百米半决赛马上开始。	苏站在博的旁边，那块头。
整理老照片侯德健？唐师曾摄alink	唱完中国人再走……
你的就是我的，我的还是我的！	喜欢这个男的多些，一笑真可爱
＜美国恐怖故事＞有点精彩！可惜刚出十集！	唔原来嘉哥也看的啊剧情确实是还不错哟。
#午间趣分享#设计师你们够了。（图转）	还真碰到过这样的，还有更离谱的
装个雪人，容易吗我……「转」	装雪人可以。但是装雪人吓唬人就是你的不对了。
以下东西，只要你曾经拥有过一件或有印象的，就说明你老了。	这些我都有，那我不是老盖了？
我想要的不过是一个不管多难却始终都会在我身边的人。「转」	我只是想陪在你身边罢了
当时我在想：是衣服太紧。还是我太膀了。	你在膀也是个菜球风太软了你知道吗
android应用操作系统使用率情况	我的华为2.2，戴妃2.3，小米4.1
全家不是你家，宜家才是你家！	这两个有点""哦哟""！
“我帮你打老虎！”，这句亮了。	哈哈，该打，现在出租车司机就是老虎！
据说，很多人，这一周就一件事。等放假！(:з	Yes。tomorrowisholiday。Yeah！
我们生活在PX制造的世界alink	不用担心，不要害怕
看到这样的文案，我表示彻底惊了。	呵呵，我恍惚了一下才搞明白。
亲爱滴小霏霏。生日快乐！mua。	Happybirthdayto霏霏。
#虎扑图片#阿呆正传，你看了吗？alink	人生就像摸头，你永远不知道下一个摸的头是谁的。
换成这个头像了，大家觉得如何？	一周用1次一一周五。中国这一周。
新浪你真是曲线救国	原来这么多公知默默关注
本内特这小伙也不错，可以漂移投篮的大壮。	今年的新秀从质量上来说就已经让人有点失望了
名字里“轩”的朋友们，你们躺着中枪了。	萧亚轩表示亚历山大
能把雪人堆成这样的，都不是凡人。	要是被开飞机的看到了，估计乘客就都不淡定了！
你在那里，我在这里，只是怀念，不再相见。	只是怀念，不再相见！
刚接领导通知，周末两天加班。为了大家有更好用的微博，拼了！	那样会有更多人爱上微博的，嘻嘻
出差回来，迎接我的是我儿子给我做们一家做的梨汁酸奶	赶紧给阿姨也送一份过来。
安全厂商各就各位，准备抢Juniper五道口的人啦！	安全融入业务才是通天大道，看透者不会离开的。
2041年的iphone是这个样子。alink	安卓论坛一天到晚转iphone。
女朋友给做的西红柿鸡蛋汤。感觉这辈子都不会再饿了。「转」	极品女友哇，好好珍惜…
立陶宛设计师VaivaNat用羊毛毡给猫咪设计的小窝。	貌似有一套。每一个都孤品啊。好像要一个。
我真心想吃个头大的小龙虾。	头后面加个儿字，就没人误会了，你这么大，他们怎么读都可以
没坐上头等舱就挑一没坐过的机型飞一飞，波音787。	787又瘦又长，真不好看
《危机边缘》（Fringe）第五季剧照组图！9月28日开播！	哇咔咔咔咔咔，能你也回来了
接下来是斗兽场，古罗马的娱乐场所.我拍我的相机.	尼康d300s+尼克尔70-200/2.8GEDVRII
超好听，陈奕迅唱陈百强噶歌——《等》alink	何故明是痛苦伤心还含着笑装开心
那些年我们一起追过的车，说说属于你的Style是哪款吧！	不在这里面。而且我也已经得到了。追到手了。！
走好选择的路，别选择好走的路，你才能拥有真正的自己。---杨绛	哈哈哈。这句话又被断章取义了。
文化的落寞，说明人心浮躁	这个断层是破四旧的后果，已经无法再接上了
如果你也和我一样，就也把这张照片转走……	Ｏrz我们都是苦逼的娃
开车到布拉格庄园来玩，让姑爷给我照一张照片，感觉不错。	杜大爷这体格怎么看着像是练举重的呢
某单位门前的狮子，太威武了，瞬间被它秒杀。（转）	差点笑抽了转不了了，哎哟我滴嘛哟
人生修炼的过程，就是无限接近生命本质、事物本质的过程。	了解自我，认识自我的过程
来，张开嘴。姐姐给你检查牙齿！好有爱的口罩啊！	怎么觉得有点儿慎人呢。
路上遭遇乞丐，给还是不给？纠结。	成心气人吧，这是？！
北京出租车司机霸气外露的午休！	微博搞不好把这人害了
我们回忆年少被爱的时光，就像自己曾是个美人一样。	心年轻，永远是美人！
杭州又下雪了，雪中西湖是最美的……	想起张岱的《湖心亭看雪》
放了丹麦老板鸽子，看来背后的伤不轻。	能推荐一位盲人推拿师傅吗？
居家的人们，这样是不是就不怕食物返潮了？	把自封口剪掉就为了实现小妞的推荐。
动物们小时候的照片，真可爱啊。	再笨也不能失去思考，再2也不能失去理想，哈哈哈哈
盛光祖这次是背着手站在温总身后，估计是怕手表被曝光吧。	擦，这是浙江省长！瞎了吧！
看到这个，我不想谈恋爱了。	就这样，人们又不相信爱情了
通州奥体公园，潞港音乐啤酒花园，15日晚，老歌老友，走起！	几点呢？我们都准备下班直接去了！
北仑总决赛，我和亚文又见面了。	战友+姐妹，再次相聚，一定很开心吧？！祝福你们！
一张反映当今社会现状的图！不能听，不能看，不能说。	不听广播，不看央视，不说人话。
大家现在每天是这么过的吗？！「转」	这不感冒了，这大热天的
#李钟硕#大长腿！大帅哥！大暖男！大伙伴！	我和我的小伙伴都很喜欢他。
十大短命小习惯。（转）	貌似中枪不少，对着电脑超过三小时是生活所迫，没有办法。
干脆面还真是死皮赖脸的。（转）	这个代价抢的太少了
成功就是从失败走向失败，而热情不减。（丘吉尔）	最大的破产就是绝望。
尼玛啊，不带这样坑爹的。	现在带面具的认越来越多了，抵制所有的不自然外表。
#我要旅行#西藏天湖纳木错——“情人的蓝色眼泪”。	马上就要去了，鸡冻啊……
今天又吃了一次驴肉火烧，加一碗驴杂汤。	你自己就是一个秃驴！
说实话的最大好处就是，你不用记住自己说过什么。	此话送给韩寒太合适了
灞柳飞雪漫天起舞鼻炎就范口罩遮面五一劳动伟大光荣！	哎妈呀。姐今天早点睡哈。哈哈。
雷丘年糕。你舍得吃吗？（这也太可爱了吧。）	画出来的，不过画的不错呢
#新车亮相#全新丰田卡罗拉官图正式发布。	我操，漂亮，比现款好看一百倍
天下无不散的宴席，这一对结婚六年，他们日前对外宣布离婚了！	那可爱的苏瑞肿么办？珍惜好难吗
东京的公寓，很奇特很多彩。	法国留学，法国美院艺术之旅夏令营，详情请加QQ群：228119784，谢谢
视错觉。有点不相信自已的眼晴了！	我们是不能正确地主观认识客观世界的
王琳佳在腾讯的微博，一路走好	这个就没必要挖出来了吧
每一个你讨厌的现在，都有一个不够努力的曾经。	别让未来的你，讨厌现在的自己。
【各种深海恐怖总有一张让你害怕】	开始觉得也没啥最后一张吓尿了
旁边有三所学校，还好今天没大风，但消防怎么不灭火呢？	说是消防车进不去？
“太阳尚远，还好我们有月亮。”晚安，晚安。	晓天将近，阳光也不远了。W.N.
在波兰的工作结束了。再见华沙，你好基辅。alink	贺炜兄，喜欢你的解说，希望你能多辛苦几场。
第一次在上海下这么大的雪。	三教那里是全家了。
今天最最手贱就是回了个“来了……”后悔死	你若安好，便是晴天。哈！
手绘表情秀，很漂亮滴说，转起来留着写日记用。	果断转了先，慢慢学。
能力只意味着能做什么，态度才能决定做得怎么样。晚安。	能力可以慢慢提升，但是态度确实人所不能。晚安
真想一个人背着包环游世界无牵无挂	想想就开心。春光明媚啊
如果你家也有一只猫正在骚扰你。	我家猫猫睡在键盘上
那件衣服正面就是这样平常。	平常正面有惊人的身体。
给你“任意门”，现在的你，最想通往哪儿？	去一个没人能找得到我的地方。
终于回来了，好累好累啊！	回来就好，开心就好！
这猩猩真牛B，在敲35下之后终于把棍子给砸断了。	第56分钟56秒，真断了！
又一个相当于周一的周六开始了，早。	嗯，六这个字你敢提啊原来
疏远谁有时候并不是讨厌或者是太喜欢	很讨厌这种喜欢的方式，喜欢就大胆些呗，干嘛婆婆妈妈的。
做PHP前和做PHP后。（图来自QQ群作者不详）	靠居然黑PHP有意思么。
小鹿是一种纯洁的动物！	班比。！sooooocute。！
新浪微博是在搞乱时间线吗？要疯啊	我以前说过新浪微博以后可能会无疾而终。做事没有啥思路的。
为什么我的手机开了飞行模式从四楼扔下去还是碎了？	这就是手机商坑爹了。
这又谁的文章，都不署名？！alink	原文地址和署名我一评论发出来就被删，呵呵小秘书真忙。
李世民他爸有三个乳房。	明明是三个乳头，李世民还舔过
午夜时间，猜猜我手里拿的是什么^_^	全国联考是怎么一回事！？
长沙，雨天，酒店，赖床，等飞机，回京、、、、	你说话是有多省啊虎子我们这边艳阳高照好热的说
快来听我唱的《爱》吧！:alink(#爱唱#制作)	很好听，感觉到不一样的味道。
鹿妈妈带着两只小梅花鹿，悠然自得。	在普世价值观中，看到慈悲。
马连道家乐福持刀伤人案最新通报	想说什么？砍人的是精神病人？
这是我见过的最牛的沙发。	坐下去······会不会······坍塌啦？
【权小静慵懒青岛游】八大关，花石楼，楼顶瞭望台。	这一会青岛一会西安一会西藏的，求请假攻略…😌
美美的蝴蝶树。据说转发蝴蝶树的人，会好运久久。	本来不信的，但是我太需要转运了！
《徒步中国》快要上市啦！alink	。到时候去买一本。
Karen正式成为sober的媳妇，哈哈	刚看到啊，恭喜恭喜！
马刺93-89灰熊，西部决赛2-0领先。	好吧，过程挺精彩的
同行说，蒙牛的事有禁令了。	有禁令就是坐实的意思？
<草原上的小鲸鱼>无比美妙的童话故事「via大象ROV」	好了可耐的小鲸鱼，也来庄里喷点水吧！
冬天穿这毛衣一定很暖合吧！	等待着僵尸的到来。
肩并肩地面对一切挑战！诺基亚820，更多精彩尽在alink	请问820拍照效果怎么样？
Iwish__________________________me.补全句子，自由发挥。	Iwish不用吃东西前看成分表……
【国外媒体关于卡扎菲身亡报道封面】	#报纸头版推荐#国外媒体关于卡扎菲身亡报道封面
没有这碗红汤奥灶面的寒夜，最难将息。	是到胥城大厦吃的不？
把女神灌醉了，果断开了一间房刷官网。	便宜了那个拍照的。
我是老了。现在随随便便就是世纪之扣。	但是砍分就像砍白菜还是可以的
唉，一洗车准下雨，一脱秋裤准降温，c'estlavie。	绳命是入刺的井猜……
丽江旅游最强攻略。需要的同学收藏吧。	丽江的确是个让人难忘的地方
这是很多北京小孩人生的第一辆死飞，你呢？（转）	原来我四岁的时候就有死飞啦！
大雨中等待主人的狗狗！	好让人感动的狗狗啊
顺利完成体测，可以上岗啦！	恭喜啊，早晨看了报纸，发现那个体测都不是人定出来的啊
#下午茶#【轻松一刻】清明上河图之城管来啦！	平地里一声吼，管叫人影去无踪。
和它们比睡姿，我输了。（转）	哈哈！搞笑！求互粉！
Vday，我和我的小情人们	杨总您的基因真强势。跟你长的都好像喔
王小波谈《黄金时代》视频（请无视主持人）：alink	一个灵魂高贵，心灵自由的人。
【广州房价环比跌超一成，天河均价暴降一万】alink	为毛深圳动都不动呢？
一个直男的思考方式……太尼玛……直了……	比价比一淘方便多了。
超萌超有创意的街头涂鸦。太赞了！（转）	超赞、、立体感很强唉、
鹦鹉弟弟偷面条给狗狗吃，太有爱了啊！	可爱的小鹦鹉啊。大爱。
【午休时刻】一张狠图告诉你什么叫：坚持就是胜利！（转）	毛主席语录：胜利就在'坚持一下的最后努力中！
地球真的变暖了吗？	看妹子的腿就知道，地球变暖了。也，，，变大了！
76平，比赛还有最后4分40秒，胜负难分啊！	柯凡犯了什么事？还是跟你混了剃了个这头
如果哪天小丑哭了，你会不会觉得他是在搞笑！	在哭的时候别人在笑！
很有创意的插座。可以改变角度	有谁知道哪里有卖啊？
我去，这是什么神功？。	衣服里面是个架子，脑袋下来的时候屁股往后撅。
喝醉了才知道你最爱谁，生病了才知道谁最爱你。	醉过了，病过了，也就清醒了。
有时候，微笑只是个表情，与快乐无关。	微笑有时候也是礼貌.
#杜锋退役#苏伟今天很欢乐啊。估计晚上的活动他戏份不少……	看到寿星大鹏啦…这仨还真喜庆…
【好男人】令人感动的一件事儿…（via：日本流行每日速报）	我想知道，为嘛为尿？她几岁？
大选封门几百天，家里边没米没柴，已经揭不开锅了。	这个不是秘籍吗……
应广大魅友要求，放一个无水印版海报。PNG格式	垃圾魅族还在玩m8那套
广州暴雨…全国都是坏心情我在:alink	我也在天河城附近哈哈不知道有木有机会看到你
开着车听着李健的＜贝加尔湖畔＞好抒情的歌曲！	开着车，听着歌，发着微博，注意安全啊
儿时用这个玩过恶作剧的请吭声！	乡下孩子谁没玩过啊
八卦一下：哈林和阿mei是好了吗？	都是曾经，当然不能和前妻比。
【大众眼中的移动互联网】躺枪滴童鞋，转！	欢迎莅临淘宝热销女包包店alink
那些不太常见的奇葩植物，太多从未见过的了。「转」	好美啊！真希望有一天能亲眼看到这些神奇的植物！
刚到办公室！怎么又冒烟啦！	您和杨澜前辈看到同样的景观喔
高中数学只有两种题，坑爹的啊	即将成为高数老师的我。略显蛋疼。
韩国小姐总决赛，真难为评委了啊！	韩国的人长得一点特色都没有、个个都是同一款的、
杨元庆同学，您使用的是iPhone4么？	带套iphone4:转发微博。
#赠小徒#人生如浮云，雨过及时归。心知农家苦，几分是怜惜。	大师，为何小徒弟取名一毛？
昨夜在高雄！满场劲是黄金甲！威。	哈哈哈，哈林哥这照型太高科技了。威武
有些事情我不看透，不是我太笨，只是我太善良。——小丸子	我爱小丸子是因为她那种性格。
我读书少你别骗我，求典出何处。	我记忆中是沈殿霞肥姐的某部电影台词
要去美丽的海边就必须穿wnp的比基尼和背wnp的袋子，哈哈！	服装好抢眼的。期待看到挂在身上的的照片
戳中笑点开关，活活乐了一早上。(转)	还喔喔喔类，鸡语。
《心灵空间》猴子跳的时候，只跳到它抓得到的地方。	坐下来，让心翱翔。
对上以敬，对下以慈，对人以和，对事以真！惟觉大师	这是一个普通人最基本的美德，而已。
【动图】孙杨这是天然萌啊！(via孙杨微吧)	有必要这么可爱吗，心情不好都被逗笑了.
四班表示亚历山大。转自bjdvdgaze.	三班那妹子不错！四班的后台太硬！
【放下过去课程第三天课程分享】人生的多数恐惧是自己吓自己！	问题是怎么能不吓自己？害怕是一种感觉。
眼看快奔三了，可是我还没二够呢。	眼看快奔三了，可是我还没二够呢。
两星期没有来，山楂花败了，山楂落果了。	这是山楂啊，我还以为是以罂粟果呢
央一正在播的纪录片《苦难辉煌》谁看了？怎么样？	不错的，好像是刘亚洲写的，尊重历史。
【夜问】有关部门把China搞碎了，怎么办？	有关部门把China搞碎了N次。
流光容易把人抛。红了樱桃，绿了巴蕉	吃完樱桃，丢了芭蕉，肚子好饱
陪伴与懂得，比爱情本身都重要。	陪伴与懂得是比爱情更加可贵的事。
熊孩子来求饶。然后，我就饶了他，。	有爱的老师，我喜欢
普通妹子和你的区别卧槽！膝盖都是血。_(:з」∠)_	珍爱生命，远离卧槽
【足球趣图】巴神很忙	尼玛的各种经典啊！
乐一乐吧。在淘宝上让人乐死的打字错误。	奇葩淘宝人更奇葩的客服
《致室友》——真实的大学生活，纪念上学一起瞎混的日子。	真的很怀念读书住宿舍的时候。
西藏，纳木错的日出，有种洗净心灵的感觉。	繁华散尽，洗尽铅华…
有想过办公室可以这样玩么。真是太欢乐了！	我们办公室也可以这样啊
医药股机会在并购alink	如果，是这样，医药A股内幕交易满天飞
见过二的，没见过这么二的，“我喵。喵勒个去。”	娃哈哈哈自我意识不够强呀！
这些蛋糕真的可以吃么，精美得媲美艺术品了。	太美了，给我肯定不舍得下嘴的。
我若不勇敢，谁替我坚强	我若不勇敢，谁替我坚强。
#南圭丽#超美的公主范儿婚纱。	可惜都是整出来的。有钱就行了
拍到一张如此驾车的司机，照片找亮点。	下边必须上来帮忙了！
在俏江南，厨师才是大明星啊！	在家，大明星才是厨师阿
温家宝：房价还远远没回落到合理价位！	7炮一平米，按当地物价水平算alink诚招代理分销
今天的行动和改变，是为了孩子明天的笑容。#儿童节#	给未来的孩子们一片幸福的蓝天
最疼我的男人我真的很爱你。（via小凤凤的小图图）	必须爱俺家老刘。那是上辈子情人呢。
今年中秋，月亮不仅要唱歌，还要说话。moontalk相约北京	有亚亚姐的陪伴真的很美好
一通惨烈的宵夜之后回去睡觉喽	好饿，看到图片仲饿。
家里门厅的过道，好多照片啊	哇哇，成龙大哥的家哦
转述中国官方说法：诺贝尔文学奖像个笑话。	俩得奖的都是你校友吧？
令人醉心的美，酒红色西班牙街道，看了你会不会醉	酒红色西班牙街道，看了你会不会醉……
7.2平米的单间，做得太出色了，稀饭吗？！	好想有自己的一片小天地
自焚民谣流派代表歌手李志在编织袋的掩护下潜入花田音乐节	BB早晚得死在和谐社会的屠刀下。
淘品牌，拼设计（图为裂帛、茵曼、初语头图）。	这几家都是网页漂亮，设计出彩，但衣服质量实在不敢恭维
古人是怎么称呼颜色的？语言的意境！	看看古人的淡定，利马觉得自己浮躁了
【轻松一刻】不怕神一样的对手，就怕猪一样的队友！	他肯定是对手派过来的卧底
向XX同志学习，XX同志一定是牺牲了的。前苏联总是这样。	崔你是否担心过、你的言论会引起外交纠纷，我替你担心
#郑在晒晚餐#吃完晚饭了？公款私款？	你的粉丝肯定大部分都是私款了。食堂居多吧？
回来结婚吧。---原来爱情也可以这样真实。（转）	你永远不知道有一个为了你们的未来去奋斗的人是有多幸运
总有个把蠢货是你不能抛弃的朋友。	对阿不知道那个人你现在能感受的到我说的是你吗。
今天外面阳光很足，正儿八经滴！	您长得很美，演得也很认真，但由衷地觉得这个角色不适合你。
鱼腥草是最难吃的蔬菜！没有之一！	鱼腥草是菜还是草呢？
是不是有流氓的气息。	某个镜头有点像年轻的施瓦辛格
新百家姓排名，老“李”第一……	“习”已经不许其他人姓了吗？
Hellokitty和哆啦a梦的女儿。（图转）	女儿叫做哆啦Kitty，儿子叫做Helloa梦
不要向任何人诉苦，因为20%的人不关心，剩下的80%听到后很高兴。	世上好人还是很多，不发泄怎么行？
沈阳人民相比他处，听课很温、很平、很胆怯……	那是，我们辽宁人都很委婉，很尊重老师！
星巴克月饼！想吃的举手！	还是好好卖咖啡吧山西驴子学马叫
第1000条微博送给自己，29岁了，生日快乐！	生日快乐，祝事业越做越好，越做越大
“我的力量传你了！去保卫我泱泱中华大地吧！”	感觉真好。美美的！
作为新的大学生最大的改变当然是变帅！alink	不会是在录“大学生了没”吧？那赵哥真的是名副其实的大学生咯
温网今天女子半决赛，还没有开始，老潘带来他的大照相机	老潘不会扛一个比他还大的相机吧。
博弈论！你的答案是_____。	当然集体选A啊，有什么疑问吗
是恶搞吧？某大学男生脚踩五只船，遭四老婆集体示爱！	大爷的，让人艳羡啊。
泰戈尔《飞鸟集》愿生如夏花之绚烂，死如秋叶之静美.	愿生如夏花之绚烂，死如秋叶之静美.
下班？好嘛，找把雨伞躲起来。	上班？不好，找个洞洞钻进去！
我就是想调查一下，还有多少人记得卡内奇·古哈这个名字。	我是云，闪电是我的朋友！
春时花开绚烂，引得蜂舞蝶忙。秋来处之闲静，总有一份凄凉。	凄凉之时就静静品味享受凄凉。
用10000支吸管拼成一张椅子：这是何等的需要耐心及细心阿。	一个屁股上去···很多个圈圈···嗷···
唔哇。其实我真的挺喜欢张翰的。o(>﹏<)o。	哈哈，奶茶MM是汉堡！。
我们最先衰老的从来不是容貌，而是那份不顾一切的闯劲。	人越大。胆儿越收。顾虑也增多起来。
#运动健康#多下蹲，少弯腰，少腰痛，请看动态图片演示。	跑步后，右侧髋关节弯腰即痛，请问怎么回事？躺后起来尤为明显
苹果公司到底多有钱？看完图你就知道了……转	原来主题是骂三公的
今天，入职中文在线7周年。	咦，是315入职的吗？
这是最幸福的时刻！没有之一！有同感的请举手！	为什么我每次都有锤它的欲望呢
近视眼伤不起啊。via沪江cc猫	还有。剪头发，不到剪完都不知什么样。
清晨走在这样的小路上，该是多么美妙！	如果住在这里，我整天溜达。
【2001年新民晚报上的房价】一张2001年新民晚报上的房价。	不想不想不想长大……悲催
亲们：北京今儿又下雪啦	湘姐，好美啊！好瘦啊！怎么瘦的呀！教教我们呀！
这张图告诉我们：愤怒是解决不了问题的。	请问这个球练过什么功夫
当年幼的悟空遇上年幼的唐僧。「作者未知」	好好玩啊，每个人都会有童年美好的回忆。
用这东西的忍者龟叫什么来着？	后面的人以为你“疯”了
广州地铁的真实写照，有同感的默默转了！	广州地铁的真实写照，有同感的默默转了！
宽恕某人是简单的，但再次信任他们就完全是另一回事了。	现在觉得这是不可能的了。
哥只是个西瓜。一个上了年纪的西瓜。	还是个“凶巴巴”的西瓜！。
韦德进攻中膝盖撞到吉诺比利，一直很痛苦，下场走路时都不稳。	马刺已经宣布加冕？哈哈哈，继续等
最喜欢你看不惯我，但又干不掉我的样子！	将来要生个不容易被干掉的娃。
#MUX趣玩#清凉一夏，MUX变身华丽大西瓜	目测是玩橡皮章出生的-.-
跟我一样喜欢吃榴莲的童鞋，举个手！	不知是不是怀孕改变口味了。最近很想吃
#2012百度联盟峰会#【李彦宏2012联盟峰会演讲实录】	百度未来是要云计算+框计算打遍天下了？
这家伙打扮成这样过万圣节。然后他被打了（viasein）	身子在箱子里，外面的上半身是假的吧
周一，燃烧你的小宇宙奋斗吧！	毛孔里都散发着帅气。
#快讯#【跌破1900点！】上证综合指数今日跌破1900点大关。	哭吧，满脸全是泪。可以骂人吗？
北京大风降温，空气又冷又干净。	没发觉啊，今天路上风尘很大
宁愿跑起来被拌倒无数次，也不要规规矩矩走一辈子。	宁愿被拒绝无数次，也不要规规矩矩做普通朋友
云南盈江5.8级地震7死多伤alink	盈江加油！逝者安息生者坚强
【坑爹向】你懂得C++吗？译自loadingartist.com	好嘛。自增了，我的C++啊
结婚的意义，感动万人的几米漫画！感动到你了吗？	即使只是在那一刻……
这里不是比利时，不是卢森堡，这里是青岛！	的确很美。欧式风格。
越南Pongua瀑布，想不想去走一遭？美得像仙境一般。	好美················
哎呀，好象有人要有麻烦了。	两天没上微博，什么都有啊。
当吃货遇上吃货……你懂的。（viax想念熊）	和吃货在一起会提升你的战斗力
承认吧，这就是你暑假的真实写照！	草！就是这个样子！
办公室风水：布告前放水果可以大幅提高通知的阅读率。	大家还可以边吃水果，边讨论
上海最美的瞬间，期盼与你一同仰望，这爱情的模样。	呵呵··上周才去了上海的·
iPhone屏幕碎了怎么办？一秒搞定。	无聊如果不是刚刚好碎那个地方呢
超简洁麦当劳户外广告，文案“OPENATNIGHT”（晚间营业）。	无任何多余的，赞！
【前方直击】他们太累了！（记者苏显龙）	普通的一线大兵辛苦了！
某些中国财富的来源和代价。牢子会不会越来越挤？	我不信其中一些受贿的钱才这么点
论备胎的自我修养系列。	这哪是备胎，简直就是千斤顶
再上3天班，就放假了！加油！	今年初七就上班阿！这么早？
中午吃自己包的水饺，就是不一样的感觉，好吃！	这个时候应该还是奶茶妹的微博吧
尼玛，坑爹啊！吃顿荤的要这么贵！	还有谁？一到结账的时候就这样的
Kids，大家觉得Barney的新女友Quinn如何	第七季的结局是ROBIN抢婚
同一款发型，放在不同的互联网大佬上，你们觉得谁最帅？	我怎么看着长的都差不多。
猛料来了，法版Pre31299包邮alink	PRE3的价格彻底崩盘了
真特么杯具，直接喂鳄鱼了。	nani？！求真相！系米真噶？！
第一次因衣冠不整的原因而被餐厅拒绝招待。非常无奈	这这。很休闲很不错吖
某人在淘宝上看中了某模特穿的马甲。买回家放桌上一看。	自己做一件也不错…
《求生之路》Left4Dead.真人电影版预告alink	好游戏会是好电影么？
今后，我再也听不得那句：“舜天啸，王地宝，上台鞠躬”了。	“人，一辈子做好一件事，就功德圆满了”国修老师，一路走好。
特别能吃苦，这五个字，我想了想，我只能做到前四个。	嗨，大家好，我是小白
物理真乃全世界最萌的学科	我还记得有一条物理公式是“F=IBL”呢，真理有木有啊==
第一题就敢这么坑爹么！。	神啊，哪个学校的啊，还大学语文。
“我最讨厌种族主义者和黑人。”文字链接：alink	少喊些正确而空洞的口号。自勉
#晚安苏州#你有没有离开一座城市之后，然后疯狂的想念它？	有得，在苏州生活了四年，现在基本无时无刻都想回到那里
见过这么拉轰的三轮车吗？！	真正的混合动力敞篷车
阴霾之后，遇见彩虹。（转）	阴霾之后，遇见彩虹。
已经没有什么能阻止喵星人的了……	属猩猩的，鉴定完毕
在工行取钱看到的。太给力了。	我靠，这是拍电影吧。
#NBA老照片#还记得那年的总决赛吗？	史上最平民的冠军阵容了，但是他们打出了铜墙铁壁般的防守！
其实，我不是胖，只是懒得瘦。（转）	灰常好的自我安慰！
这是一只招财猫，1分钟内转发此猫图，将好运连连，福气冲天	好运连连，福气冲天
没有不相信，只是相信的事情改变了而已	是啊！你那里也会这样吗？
所以说，印度成为世界第一强国是迟早的事	正儿八经印度＂飞＂饼
这也太快了吧！谁在北京帮我买份北京青年报？	从网络红人变成了中国名人
#时光猜电影#哪部电影中，排球变成了这幅摸样？	荒岛余生汤姆汉克斯
老家的宽带接入价格，哭了	云南和2M一样慢的4M，1200一年，啥赠送也没有
这是神马？好像很好玩的样子？	没看过《萧十一郎》么？
44平米别墅，还带车位，真强大！	在中国，会被强拆。
今晚去看＂战马＂。看巨幕的。期待斯庇尔伯格新作。	拒绝战争，珍爱和平
嘉宾上场了。好戏开始了。	不雅观，书白读了。
分分钟大气儿不敢喘啊……	第四节太不给力了，太铁
京城的哥用他的随车武器，到底是有多堵！	我站在高岗上向下望〜〜
国庆日问自己:谁可相依？	只有自己，其他都是某一定的时期。
人的一生注定会遇到两个人，一个惊艳了时光，一个温柔了岁月。	人的一生注定会遇到两个人，一个折磨你的肉体，一个折磨你的心灵.
中国互联网大会？大杂烩！alink	大家都来说说开会
虽然自己不用iPhone，早上还是跟着起哄，手痒在官方下单了一部。	真爽，想要就要唉。
曾一鸣是强化版的金志文、弱化版的吴彤。	…只可惜歌被剪了四分之三
法拉利Aliante.丰满的肌肉感和愤怒的前脸，不寒而栗！	不要这么线条吧！美到霸气！
#其实我觉得是这样#之五十六鲤鱼撸管的起源	噗·················
非死不可的新界面，看看这次人人和微博抄不抄	。新浪可以这样friendsandtheparty
5分钟教你最潮的25个围巾系法alink	只有涉及到手巧的，统统不会
明明是只萨摩。你也不要伪装兔子嘛……（转）	就是👂不怎么像啊。
又戳中笑点了！（图转）	吕子乔演的越来越好叻。
江苏化学天才在美国自杀：alink	哎，他的父母应该一直以他为荣，怎知道最后这样。
什么是坚持？就是一天，又一天，你告诉自己，再坚持一天。	就是一天，又一天，你告诉自己，再坚持一天。
你认为哪一种感情更真挚？	情景二要看老公说话时是什么态度。如果是调侃的当然很真挚
环形插座，再也不用担心插座孔不够了！	创意不错，不知道安全否
绿叶青葱的夏天，空气中弥漫着阳光与幸福的味道。早安，各位。	主页君的每张配图都好小清新的说
今天不想说话，累的•••	不想说，但好要倾诉！
#开心一刻#“肌肉”中的奇葩······确实毒性不小啊！哈哈哈哈	脸都是做仰卧起坐的时候练出来的吗？哈哈哈哈
经过几个阴霾潮湿的天气北京今天突然放晴了	有没有人想淘宝兼职的，有兴趣加我Q34265938
保利的房子还好，但保利物业管理就真不是一般的烂，非常烂！	正在保利天玺做园建，那个烂物业处处为难啊
好吧，谢谢诸位留贴，80，90后都知道《追捕》，我就放心了。	知道真由美的不多了，都知道优乐美
大家猜猜这是什么，猜对的我回复。这可是硬货。	嘻嘻，可以加我Q不？
北鼻蜡烛不是这么吹滴。	经典的是勒崽儿郁闷地哭老😂
如果有一天，早上起来发现突然变了性别。你的第一反应？	回床上睡觉，醒了就无事。
各位伙伴们，熬夜的后果请自负！	我唔想咁，我要早D瞓
日本的红桥，如此极致的用色，走在这一定会忘掉很多烦恼。！	惬意，只因身在此桥中。
是石头竭力开花的时候了。（BY保罗·策兰）早安！	七月，是时候飘场雪了。
苍老师流泪了。为了日中友好，她受委屈了。（TBS专题节目截屏）	其实苍老湿这个人还是不错的，，，，但是可惜她是日本人。
【央视315晚会曝光企业名单】完整版！	赶紧投广告吧，投了明年就不曝光你了。
蓝白相间的小房子，我愿在这样的房子里生活。	并且靠近沙滩、白天阳光充足
顺利到达北京！晚饭吃什么呢。	你快补补吧。再不补就的飞了。
世界上没有比快乐更能使人美丽的化妆品。——布雷顿。早安。	笑容代表你的心情，早！
首都机场T3，一男子喝多，酒疯比较严重，被保安拖离。	你们家都管警察叫保安？
好像好久没有人说喜欢我了。	我一点我不喜欢你。
致青春。（虎扑篮球）	我们的青春正是他们走过
北京春天的夜景，湛蓝的天空。再污染的城市也有美好的时刻。	男哥，崇拜你！您现在哪高就？
男人，就像食堂的菜，虽然难吃，但是去晚了居然还没有了！	男人，就像食堂的菜，虽然难吃，但是去晚了居然还没有了！
犹记乡间小院，雪后日暖风静。小鸟枝头聊天，看着真是高兴。	秋日尽萧瑟，独来庭院幽。枯枝三两鸟，嬉唱万事休。
今天比赛的最后阶段，大概就是这个样子的#差不多一个意思#	步行者最佳第六人----克劳福德
聚精会神写微博，一心一意为博友。	老爷子精气神真好。
早上5点睡，上午起来收了7个快递，会不会得脑癌啊？	帅哥，要注意休息哦。！
渔舟唱晚，化蝶轻歌，摄影：DucanhDo（800x600）	心有灵犀，翩翩起舞
央视报道江苏和浙江经济现状。	全国经济都是如此，房地产就更热闹了
相恋到如今，转眼已六年。alink	祝福祝福，郎才女貌哦。
这张全家福太奇神奇了。via：小九的异想世界	底下的哥们应该露露脸
害怕困难时，试试这个。太励志了！「转」	是的机会把握在我们手中
又是电梯事件。俄罗斯男子电梯外救狗！好悬。	我家狗上回，幸亏绳子不结实
西直门嘉茂浓烟滚滚。今儿风大揪心！	哎呦哄我们下楼了又
手腕受伤，从此退出乒坛。	不会吧，还想在离所前求虐一次呢。哎。
年轻时的林青霞，无需施粉黛，美人自清丽。喜欢的转走吧。	似曾相识之感，惊艳
【一张图带你看苹果发布会新品】	看的人家春心荡漾的。
我建议：莫言赶紧就势建立一个""莫言文学奖""，不亦快哉！	是的···让微博消停会儿·······
蔡京其人，字写的还是不错的，尤以行草见长。	贪官的字一向不错的
要是开放去钓鱼岛的旅行，钓鱼岛早就收回来了。	占领！站着也能领它！
都说力的作用是相互的，除了爱情的力量。	力的作用是相互的。物理。
小米网兄弟们的圣诞愿望树，大家觉悟真高：不涨工资，加班！	人家说了明年抱个金宝
就算全世界都抛弃了你，至少还有我。	有一种奇怪的感觉油然而生。
其实，都是你在觉得。	其实，都是你在觉得
不找父母要钱，不花父母的钱，是成人的重要指标之一。	参考以上条件14岁成年的飘过，，
20%个税激起各地过户潮alink	同时也逼着无房族抓紧时间去买房，国五条太猛！
伦敦的雪，像童话一样美丽！喜欢的转发吧！	像童话一样美丽！喜欢的转发吧！
海绵宝宝的傅立叶变换就是派大星。	在wolframalpha.com输入""Fouriertransformrect(x)""就明白了.
猜猜看这个少数民族歌手是谁演的？旁边愤青画家又是谁？	这造型一般。比马总年会造型差不少。
暴强翻译：日语“我死了拿你开刀”是什么意思？	想死你了！意思一样一样的。
在最好的角落，坐拥书城。	记得某位作家说过他能想像的天堂就是图书馆的样子。
怕孩子坐姿不对会导致驼背近视，家长想出这一招来！「转」	阅兵部队也是这么训的
放上书，长胡子，长头发了。	这个以后可以仿一个拉，哈
一张图体现中华汉字文化的博大精深(图/网络)	以前看到过，好像是一个女孩写的吧。
没有一句歌词，却让全场惊呆的法国歌曲！alink	听第一遍就不想再听的有没有难道是年龄问题
今天舞台剧二场演出，压力很大中餐先来个日式烤肉压压惊啊。	很好吃的样子，看着我都觉得我的晚饭都逊色了！
北京出租车的月收入将达到6-7000元，超过博士毕业生的水平。	应得的，太仓都有这么多，就是开车素质有待加强
#UC早安#鸭子说，会笑的人运气也不会太差。	那为什么是鸭子说呢
今晚在这船上吃饭，有点意思吧。	又搞腐败活动了对伐
狗狗不是你的一生，你却是它的一辈子。	曾今也有过这么个狗狗
飞机上看到的一幕，太震撼了！	亲，您老坐的是飞船吧
奥利奥泡牛奶的专属利器	得多蛋痛的人才想得出啊。尼玛手指沾到牛奶会烂掉么？！
母亲节话题：你是怎样帮妈妈减肥的？alink	左边那个是有病的吧==
只回台北工作一天就又要出差了，好舍不得我的床😢。	喜欢你这裙子好清新你穿着也漂亮
周末就快到了，你会选择怎么来度过周末这两天呢？我来说:打篮球！	估计博主的水平没我高
再显摆一下，iphine5对应的nanosim卡，联通各地大规模到货了。	上海的什么时候到啊？
我喜欢你主动找我这样我就确定你不会嫌我烦。	真的很害怕你觉得我烦
据说摄影师用了什么技巧，云顿时就傲娇了。「转」好美。	延时或者定时快门，除此无它
有多少人认为国有企业是天生低效的？	举手。高效的国企有，但这只是小概率事件。
和志同道合的人一起做喜欢做的事不会觉得苦和累。	感同身受，支持一下。
别在喜悦时许诺，别在忧伤时回答，别在愤怒时做决定。	别再愤怒时做决定，
买手机之前，您能不能先买一条像样的内裤啊啊啊啊！	这个内裤是专门设计的
边泡温泉边打麻将。要不要这么享受啊？「转」	还可以随地小便，没人知道呀。
No.50硬通货：货币的战争	支持！有梦想的人！
一首ADELE的《one&only》之后，晚安。alink	如何你现在还没睡，手边有副耳机，不妨听听。
如果看懂这张图，就请默默的转走吧，你的全家就会如图一样。	长命百岁…感谢佛祖！
我不是你的好女儿但是我很爱你。by小凤凤的小图	愿意为女儿付出一切！
#灵异#一觉醒来，脑门上出现了一个＂8＂字。什么情况？	申晨老师快随便说出一组数字我要去买彩票去
今天专访老俞，各位有什么想问他？	新东方老师怎么个招法？
神奇的速算！一分钟学会！	只限于90(含)以上乘90(含)以上…
在家里喝香槟，你来吗？我在这里:alink	真想去。去了北京可以请我去您家里做客么
一边杨梅，一边桑葚，你喜欢哪个？	看着杨梅口里就会出酸水
【午休时刻】如果你明白，生命的短暂（转）	人生苦短，只争朝夕！
途经南洋小岛，看人家的贫民窟，全是海景房啊！	咱们的旁水洋房只是挖了一个湾哈！
汪不爱夏天！汪也爱杨梅！	阿列？MO也爱吃酸的？
中国领导人形象的分水岭出现了！	人民要的不是形式，是实惠！
从东京回北京，下下周去西京。	求科普，西京在哪里？
饿的我直发慌，这凌晨四点钟煮的饺子，差不了。	哈哈，饺子够多的，能吃完么？这是早饭还是夜宵？
猜猜制服小董的是谁#美图秀秀iPhone版#	这。也憋的太过分了吧！？
人生中10件无能为力的事。	大过年的能不能别发这种同意请支持！
最新沪深两市融资融券标的！共500只！	发现诸多前期大牛如猛草抗旱之流
你有这样的强迫症吗？。在蚊子包上掐十字。	我爱掐个“早”字！
多少人，以朋友的名义，爱着一个人。——《OneDay》	如果你快乐再不是为我，会不会放手其实才是拥有-《知足》
玩了一下永远的经典仙剑奇侠传一代有玩过的么？	呵呵，这是刚刚开始的时候的画面？怀念98年的时光！
原来中国的帅哥都在当兵啊！太帅了！有木有！（转）	流口水了啦。我要去找飞行员叔叔。
小丸子：“睡不着，又没有人陪我玩。”你有没有过这种落寞？	别人都睡着以后，就没有人陪我玩了
跳不过去就算了。蛋疼啊！。	跳不过去，就死了。
已两个月没和老公单独吃饭，今天终于有机会了	广州星盈办公优惠租赁彩色复印机，。仅需350元月租！
能把一只鸡（鸭）摆成一头牛的人，功力很大，很深厚。「转」	这就是传说中的牛×吗？
哈哈，这个有意思。我只是说有意思……。	敢不敢再无聊点啊！
“既然遇上了，就好好的一起过日子吧。”	这涂鸦的很不错嘛alink
女生出门必备物品！东西不大，随身携带。	应该带了冲进去骂人的···
向意大利国家德比迈进，向榜首迈进！ForzaInter！	国米还差点，尤文2:1击败国米继续拉大领先优势！
范佩西在下半场一开始就一脚铲射打中门柱！	艹！搞毛啊！荷兰队认真点好不好？还能不能打出10-0了？
〔备忘〕欧洲杯赛程，决赛7月2日2:45。	我一眼看到的是微博提醒，哈哈
早！还有五天就周末了！	全新的一天！加油！
【视频：山东师范大学学生抢考研自习室引发群殴】alink	暴力乖戾的中国人啊。
抗议白人警察枪杀黑人青年无罪释放在加州演变为街头暴力	鹰酱，嫩家的人权肿么了？
绝了，能把汉字写成这样。「转」	放屁，狗屁，方便……绝了。哈哈哈哈
主人，你这个二货。（图片来自网络）	咋一瞥。小小惊悚了一下。
闺蜜等我们也老了，一定也是这样的。	等我老了，能这样，美死。
梅西要当爸爸啦！女友周末剖腹产，帮忙取个中文名吧	梅里斯蒂亚诺纳尔多。
分手时女友说：你给我玩蛋去！于是……	没说滚蛋。要说了岂不是变成屎壳郎了么。
#在路上#日本河内富士花园的紫藤隧道	想起宗璞的<<紫藤萝瀑布>>
把西瓜吃成这样真是个技术活。（转）	用掏耳勺次滴，鉴定完毕
请祝我周末不加班！	希望你周五，周六，周日，周一都在家打酱油
对于一个徒手开椰子的女友，我是不是应该穿防爆服。(转)	没用。他能布雷公雷。
我能说句实话吗？我觉得这事儿可能大了……	估计说的是湖南那个高考什么的吧。
越南Pongua瀑布，想不想去走一遭？美得像仙境一般。	越南Pongua瀑布，想去的转起。
今晚凡客，会送出一份满五岁大礼。	我好像今晚没买什么？那会不会有我呢？
新闻自由日。新闻自由？日！	悲催的记者，可怜的人民。
《一代宗师》这海报，我怎么就总想笑……	这绝对是一部讲述二人转的文艺片！
你永远都搞不懂一只猫的世界。(转)	心都要碎掉了，太可爱了
到了七月，一年又过去了。	嘘，你的嘴咋和棉裤腰一样呢！
只有被侮辱过的生命，才会更深刻的被人怀念。	己所不欲，勿施于人。珍惜每个生命！
对想了解某个领域的初学者来说最值得推荐的一本书。（转）	这是视力表！请求搞张清晰一点的！
国外某知名男星被发现横尸荒野。丨揭露者:不详	谁能证明海绵宝宝是男滴
据说这张图，很多处男都看哭了（图：网络）	玻璃刺穿TT，屌丝最终难逃备胎命运
重庆出租车排队加气的照片。尼玛这是祖玛吧！（重庆晨报）	哈哈，最喜欢打祖玛了
NBA赛季预测（二）：阿德尔曼将获最佳教练alink	当家球星………一个都伤了
梁文道:书读到最后，无非是让我们能够理解这个多元世界的复杂性.	也许是让我们理解这个多元世界的简单性吧？
我猜，今天的雪有这么厚	……下巴……好猥琐……
一条悲催的鱼，跳到半空中被冻住了。	世界是五彩斑斓的，但是也要量力而行。
发福利啦〜公司还细心地分了男生版和女生版	广告帖还说福利……
光棍节和我有什么关系，那明明是男人的节日…	我一直把你当男人了
各得其乐！一会儿再去看月亮！	哈哈，今晚太多人关注了。不眠夜。
再穷，也得给孩子送生日礼物！	这孩子他爸真舍得花时间精力。
把小孩和狗放一起养的结果超级温馨！	第三个狗狗笑死我了
看看亚马逊和申通在忙碌的时候的区别。（转）	这样还能送到每个买家手里才是技术活啊。
新秀赛，上座率这个低啊，不到百分之十	联系国内各大旅行社开发成强制消费项目，美其名曰观看NBA
如何在互联网上建立你的品牌形象？	懂的人知道该怎么做了。
大脚印游泳池，戏水也创意！	好像跳进去。跳进小脚趾姆头。
2012年，我要变的强大起来，保护那些我在乎的和在乎我的人。	哈哈，这孩子真有喜感！。
对哥来讲，周五最悲惨的消息就是……周末出差	错，出差没美女陪着
您看着大明白有点培养前途没？	有范！还是看她自己喜好吧
#点炮#：作为中国人您真的自豪吗？(9.2)	中国人有什么可自豪？哪一点？还想卖弄“五千年文化”么？
令人尴尬的是，当你已经知道真相，他却当着你的面撒谎。	呵呵不在乎的话就是一坨屎了
梁博最后拿冠军的话，我去参加第二季。立帖存证。	我九四淡定的来通知一声，第二季启动了。
从自己的身体到自己的心是一场最远的旅行。	问一下这是在哪里啊？
可能就因为这样一个倾斜设计，我就选他家的插座了（viaiamsujie）	一般的设计貌似都是错开的吧
现在的房地产调控像在下一盘很大的棋。	这也能狡辩，发几条书上的真理就真以为自己的哦话是真理了
兰州的黄河铁桥，上次上这座桥大约是30年前了。	兰州变化还是蛮大的
最浪漫的事就是一起躺在床上嬉戏相拥睡觉做同一个梦和你	我能想到最浪漫的事是和你一起慢慢变老。
【8090后绝对不懂的人际关系经验】记下来，绝对有用！（转）	确实很不懂现如今极其复杂的人际关系！
那些所有你以为过不去的过去，都会过去。（via：郭斯特）	握不住的沙，放下也罢.
忧愁，无法入睡，革命在低谷。	思想的禁锢是一个人在这个时代最大的无奈…
第三十届百花奖影帝，＃陈坤＃，＃赵薇＃	程老师。你故意折磨我们呢吧？好让我们羡慕。
【泸沽湖畔洱海】只愿生于此，住于此。	云南大理。千古如斯。
好萌！还有小尾巴！看见没。(转)	等女儿大点也可以让她COS一下
我们的救援队已到达基地，已安营扎寨稍做休息调整。	你都有那么有心加入救援队！
#看不见的武大#校园最长的一条直路，知道这是哪么？	水院的一条路，一头是小观园，一头是五舍
#提问时间#知道死者的眼角膜对法医来说有什么意义吗？	不知道难道可以看出来死亡时间？
麻辣隔壁，又开冰箱还是加了锁的，越来越牛X了，小贱人	栽赃嫁祸。？！哔哔哔，喂喂110吗？
周六周日希望所有烦人的人都別来烦人！	身不由己。小人物的悲哀。
如果你知道这是什么，那就说明你老了。	咕。(╯﹏╰)b，不得不承认我真的知道。
有好图，求文字。（001）	烟草，可以让尺骨都兴奋起来！
这个太有才了，如果西游记也有iPhone	三藏哥哥，定个位吧
你，你要干什么？！	正常吧，病毒不断变异，杀毒软件跟着不断升级
哈根达斯火锅冰淇淋，好想吃一次！	好想吃，可是我这里没有呢
一切安好，就是累点、身上红点。都在我可以承受的范围内	抓紧一切时间休息。
瞎拍瞎欢乐！周末开心！	自拍？很有点水准，哈哈！
【创意摄影】我有一个月亮！「转」	#创意#我有一个月亮，每天把它放在身旁。
这是一个流传已久的故事：道德的起源。(bySHIN先生)	谁喷的水？为什么喷？
假如你在地铁里偶遇哆啦A梦，你会。	快带我去穿梭时空吧！
#探索拾趣#猜猜这位先生是谁？想要看正面的转！发！起！来！	站在食物链顶端的男人
幸福——就是受灾的时候遇到陈光标！	一直很喜欢他。他这么做无非就是要唤醒更多人的良知！
当今互联网最流行的模式：C2C——CopytoChina。(图/视觉日刊)	别的都好说，尼玛明明就是Twitter抄饭否，饭否躺中啊！
有一个超级撒亚人的爸爸真幸福啊！	哈哈，后面的妈妈是亮点……
作为一个吃货，我希望甜筒是这样滴。	这样的甜筒的卖多少钱啊？
杨小楼梅兰芳霸王别姬1922年（大彩图）	难道说，这就是霸王别姬的原型？
霍华德想当回汉子alink	想当汉纸拿个冠军才是汉纸中锋灭绝的年代
第79分钟，卡努特得到本场比赛的第二张黄牌，被红牌罚下。	输了也活该。踢得什么玩意丢人
小时候。哭着哭着，就笑了。长大了，笑着，笑着，就哭了。	这句话，说到心里去了！
【真心话大冒险】假如你喜欢的人醉倒在你床上，你会怎么做？	告诉他：我喜欢你然后亲他吧再然后就帮他盖好被子
我宁可保持沉默，也不要向那些根本不在意你的人诉苦。	等我有一天不诉苦了……
爱让泪水变得好甜——志永新婚写给他的妻子崔筝alink	祝福你，许先生！多谢您为我们在京的外地人争取权利！
出趟门办八件事，一点儿不浪费时间。	不只是戏演的好啊！可是好像没看你回复过谁啊？怎么回事呢？
由于众所周知的原因，AI再次更换了头像……	苦逼施工员只能过完年假盼年假
我只是需要一个不会放弃我的人。	永远，在任何情况下，都不会放弃我的人
神一样的自行车技巧，实在hold不住了alink	有点不敢相信这是真滴。
新版家规之——二十四个“要”与二十四个“不得”！	好吧之前你都说晚安了。
这两天看微博，突然想起电视剧大宅门的一段剧情对白。	这不是往皇军脸上抹黑嘛啊
真心话大冒险的恶搞题库。嗯，这个要保存下来。	玩儿这个，自求多福吧…嘿嘿嘿嘿
#环境署重点领域-反偷猎#有美图，缺警句	天堂不能作为动物的家。
周末愉快！《偶把肛门塞》！alink	娱乐精神哈哈！强大的字幕组！
刷了几千次票，刷不上，为流量做贡献了。	王老师，上工具啊。
【萌漫画】为啥布能够克石头？一直没搞清楚。图片来自imgur	因为纸是包不住火的！【咦好像没啥关系
十年历程，励志的画师！（转）	只要努力都会成功的
教你如何一眼认出英语单词的意思！（转）	教你如何一眼认出英语单词的意思
炎炎盛夏突发诗意：阿。太阳。	大海就不能遇到裂哥
有个傻子爱过你但是后来她不傻了	有个傻子爱过我，她会一直傻下去
告别美好的2012，祝大家新年快乐！	请问图片上黄色盒子里装的是什么吃的？
这个世界上，只有一种蛋糕，让你吃一次就沦陷了！——鲜奶小方	这应该是红宝石的吧
#Tango无厘头一日一画#安静周末篇:人，渔，琴.	好有想象力。带给我每天一个微笑。
你可以这样调戏你家的喵星人。	这个好，今晩回家逗猫去
养狗的童鞋们快去拿个酒杯出来试试吧！要不要这么萌啊！	太可爱啦。太是意区啦
在贵州，我们带了很多小孩子用的书包、本子、衣服	成龙大哥，小女子崇拜！
想知道比萨塔是怎么变斜的吗？	拿好你的贵重物品小心在景区外溜达的吉普赛人、阿三及黑人
夕阳很漂亮。新西兰地广人稀，证据是：银行密码只有4位。	账号有四位那才是证据
原来原来你有秘密武器啊！啊啊啊！	SithvsJedi，明显正不压邪
晋王羲之《快雪时晴帖》，赵孟頫跋	晋王羲之《快雪时晴帖》，赵孟頫跋
上半场第34分钟，卡努特梅开二度！北京国安5-0青岛中能！	厉害昂哈哈。5:0了都。牛逼大发了。
一起来填空：每天摸着大肚肚，我最想跟宝宝说的话是__________	来，咱们一起来吃饭
叶底藏花一度，梦里踏雪几回	狗哥真是杰出的伟大的日夜颠倒型诗人
报纸上看到的，各种真相啊！有木有！	太贴近现实了、
2013年上半年城管暴力执法回顾。城管，谁来管管。	百度管管城管吧，把城管相关的搜索信息统统屏蔽掉可以不
唱歌是为强身健体。？挖槽？	应该是强身健体是为了唱歌吧！
是谁和哥说特么上海很暖和来着！	今天都晴了，气温已经上升了不少呢。
刚刚得到的某大银行新发的关于同业业务、流动性的通知	确保不出现同业违约，看来风险很大
开始刷晚上的副本，喵喵喵嘻嘻嘻	好像贝壳长腿儿了。
出生日期对应的花和花语。（转）	12月31日永远被遗忘！
全球各大品牌LOGO色彩分类。	电美的童鞋们。这个可以收集一下啦。
感谢那个带你进入微博世界的人吧！你还记得ta是谁吗？	记得，只是那个人已经离我远去了
书在德国卖得不错啊alink	在德国卖一本当在中国卖好几十本呢！
愿得常巧笑，携手同车归。——古诗十九首《凛凛岁云暮之十六》	愿得一心人，白首不相离。
你长得不帅？没关系，杜杜教怎样只用一个动作吸引妹子回头看你	好优雅的转身……哈哈哈
实线剪开，虚线不剪！做一个送给ta吧！	赶快做一个给他吧，不然他就会做一个给她了。
现在的孩子真是太有才了啊！	这老师的字儿也太次了吧。
当年亚马逊和Bestbuy大战，结果CircuitCity死了	这叫神仙打架，小鬼遭殃
财以不蓄为富，官以不显为贵，名以不彰为誉，施以不报为惠。	为什么财以不蓄为富？
日本官方评出最经典35部动漫。「转」	这个排名的确很有说服力，而且没什么过大的争议
习惯这样盖被子的童鞋转！（转）	大学时候宿舍没暖气，这样是必须滴。
天上的月亮伴随一群求知的企业家在夜话。	普通企业家是在卖产品，优秀企业家是在卖思想！
【快讯】-尚德太阳能电力有限公司宣布破产—新华社。	小伍同学你也快了，怪不得你天天休息
【2014款JEEP大切诺基尊崇版官图】硬汉的逆袭！	怎么这年头都喜欢小眼睛？眯眯眼？
人人都爱好电影–读「南都七宗罪」后感	南都狗屎文，不必放在心上。
养只金毛和养只哈士奇的差别真是太大了！(转）	哈士奇还有萨摩是最二的二货
你可以这样调戏你家的喵星人。	坏拉，这样调戏，试试看
世界杯英格兰遭遇的门线冤案，今天转嫁给了乌克兰。	，误判加误判等于正确，这就是足球场上的负负得正
照相了，来，笑一个，呃。你还是别笑好了。	这笑容很“这个杀手不太冷”的韵味啊。呵呵
第三节，3:50，热火65比66，斯波喊出暂停，韦德手感找回来了！	我觉得还没有···还是打里面吧
用你的心，而不是用眼睛去看世界！	用你的心看世界，世界会是那么的多彩，那么的不一样！
移动的别墅。！大卡车里的奢华！	带上全家自驾游！油费嘛···
捷克总统主席台上偷钢笔被直播alink	哈哈哈。可爱的总统老爷爷。
占了我地方睡了好久了，要不要赶她走？	下回您先抢占有利地形，让它着急去吧。哈哈！
齐齐哈尔的火车站是我见过最有特点的车站啦	哈哈，毛爷爷永远活在我们心中、
博士后老张归国记【全文】alink	人生已经如此的艰难求求你们别黑了
哗！粉红的水晶圣诞树啊！这是舒淇说的。	每个Moment都很漂漂，眼妆超别有风情的。
这个点还在看球的。如果创业，成功率极高！	呵呵正在看球正在创业德国加油
每个人的身边都有一个爱打麻将的人，你想到了谁呢？	就起来了啊？搞搞搞！
你可以想象下，你家有这堆货！你会不会疯！「转」	两只泰迪，崩溃边缘。
上午动车去石家庄，为什么没有卧铺？我去	评论才是亮点，聪明人真的不多
老娘一分钱没有了，就剩能生孩子了，满意了吧？	这样竟然还能在一起==
韩国正在开卖中的带游泳池的豪宅······论拍摄角度的重要性233	生活技能：摄影（宗师级）
抵达沈阳，正在全城大装修，备战全运会啊。	沈阳的芗芗和你绝配。
某校的雕塑，远看像是鲁迅在玩手机。「转」	周树人都玩手机了。老师你就别再阻止我们了。
iphone官方客户端不能发音乐分享吗？	尼玛，一天到晚废话多！还可爱多，猥琐大叔还可爱个鸡巴
习惯了晚睡，只是为了等一个劝我早点睡然后跟我说晚安的人。	没人晚上和我说晚安，悲剧
别碰人家啦。讨厌！alink	小奶猫神马的最萌了
冬天就这么宅在家里吧，喝着暖茶，死守电影电视剧……	第一反应就是，脚会很冷吧！
切开这个西瓜，我惊呆了！二师兄，是你吗？	好吧，黑妹你赢了。
""你也一样追求这种简单的幸福么。""	好可爱啊，以后也给我的宝宝买。
整个冬天都不穿秋裤的男人，可以嫁。	整个冬天都不穿秋裤的女人，可以娶吗
很喜欢的铆钉鞋到了，最重要的是穿上走路很舒服👠👠	对儿，有些好看的款，可否直接转账给你，你寄出衣服呢
我想给自己一个牛逼的机会，趁自己还年轻。（转）	感觉笔者是五月天的粉
掀开海浪，看看底下是什么？有所感触，有所感悟的请转发！	应当再做个掀开高楼大厦，看看下面是什么
大哥，赢了就赢了，咱能低调点么。这图看一次笑喷一次	菲鱼哥不要这样子，哈哈哈
对，是我。谢谢喜欢……	眼睛起萝卜花了😳别这样，可爱的，能否低调点😏
两道题就会让你知道谁爱你，如果你觉得准的话，请转发分享。	我觉得自己有点傻，一开始就选了两个A。
给你们个机会，和俄罗斯DJ小妞说声拜拜！	改版后是大型财经脱口秀节目呵呵
我去骑车去了！一会儿见！	我去打劫骑车的去了'一会见
清华园。各界热议中国人幸福观。	坐而论道，其何用兮？
幻想在纽约，趁大雨天试美式新衣然后去看TheGreatGatsby！	我发觉Wyman而家同我细个阵时睇电视个样好大区别
实拍电信版HTCone，支持双卡双待，金属外壳，确实惊艳！	机器做工，拍摄效果都是不错
【没有跨越不了的鸿沟】一只感动了无数人的小蜗牛！	没只把头拉长的蜗牛，上辈子都是折翼的天使！
没有冰淇淋怎么能叫夏天呢。	口、口水，嘀嗒嘀嗒。
简单易学，孩子们又喜欢！	下次幼儿园要整水果拼盘可以参考下
可发多图的新浪微博，8点20分发#随手拍#	华为手机的默认壁纸嘛
皮特写给朱莉的信——《爱的秘密》「转」	thewomanisthereflectionofherman
靠！晚开电视四分钟而已，就都一比零啦？	你也看球的吗？（PS.我很喜欢你写的文章，加油！）
新帽子上班！中午要向萌娘学习化妆！	绝对领域！哪家技术这么幸福
刚在母校过完戏瘾，恍惚回到二十年前。alink	兄弟，我儿子说你最近胖了，注意啊！
自娱自乐是一种生活态度。	现实是残酷的，我们无法控制，能控制的只有心态！
女生的两大愿望。有同样想法的童鞋就一起转发吧。	男生三大愿望、、高、、富、、帅、、、、
没定闹铃，眼睁睁的看着就迟到了……	幸亏我昨天晚上重新设置了闹钟……
多少时候，因为得不到，所以假装不想要。	为想要的东西奋斗努力
#U粉互动#如图，猜猜是什么？提示：16G。	这么明显。除了U盘还能是什么。
马中的白雪公主，美爆了。	这马要不要这么时尚啊
詹姆斯这场在迪奥防守下8投1中。	每支球队都需要个胖子
不要太刻意去寻找，最好的东西往往出现在不经意之间。	不要太刻意去寻找，最好的东西往往出现在不经意之间。
生菜的正确处理方法，好高端啊（图转）	这样也行？改天试试…
食在有健康，健康最实在！	是很健康！不过偶要吃肉！哈哈
早啊，吃了么您？各地见面都怎么问候	早早早啊^O^去哪里？
都是一辈子，那个选择更经济？	人生短短，一辈子自已选择
养只小狗狗，生个小宝宝，让他们一起长大吧。（转）	这小孩，总想啃狗狗的腿和耳朵
好壮观的自习室，插座表示压力很大。.	学校的基本建设不太好
玩过这个游戏的。请转发。	我玩过耶，但从没打过秋千那关！
我愿用温柔对你，赶走这个世界的阴霾。	摄影技术不错！镜头很准！
一句话说明白，为啥某国外交永远那么怂？	对外是孙子，对内是爷爷
幸福是太多和太少之间的一站。（BY佚名）早安，各位。	被窝太暖，不想起床…
新都一中人，就是不一般。同学们正在有序的充饭卡。	上颜小强的照片嘛！想他老人家了。
运动会的最后一个环节，有同事的浪漫求婚	好幸福啊可惜没到现场亲眼所见太遗憾了
多少人想养之这样的大狗啊。太有爱了吧！	我还有机会吗，，美会吃醋！
无论你怎样动鸡的身体，它总是能hold住自己的头。	鸡的头有GPS定位不知道啊
又一年生日，更该长大，要好好的哦，要听话。	又一年生日，除了生日安乐，还要按时休息。
发表了博文《心的转向》-alink	理性往往难以左右感情，除非可以达到随心所欲不逾矩的境界
15点的全国气温排名，重庆！	哇！我老家排名第一啊。热死了。
新PAD的拍照效果好了很多。	欢迎对1945-1950年那段历史感兴趣的朋友关注。
#i萌宠#愿你被这世界温柔相待。「转」	愿你被这世界温柔相待
谁说中国地图像大公鸡？其实是美少女！	你意思是，中国是一个做鸡的美少女？
京AB115挂，把远光灯挂在后屁股，这傻B是要蓄意谋杀。	傻逼，我朝不允许有私人枪支，不然毙了丫的。
这货是林黛玉转世吧？病如西子胜三分啊	哈哈哈哈，一只忧郁的喵。
《自己》alink周一！自己不爱自己别夸口爱别人水：）	小石头，最近打歌频繁。
海豚也会撞车？这老兄估计喝多了……	哈。看了瞬间也开心点
能不能别这么忽悠人，到底是相机还是U盘啊！	做得很精致啊，精致得有点PS的感觉。
好像感冒了，头疼！睡了	好好休息吧，明天还有比赛了。加油
贵州茅台股价貌似要到180元。看来我上周买早了。	似乎你炒股是众人皆追我也追啊。
你就是伟大的狮子王！辛巴！「转」	估计喵星人被吓到了
【新鲜糗事】这位大姐好敢穿啊！	我在🚇里也见过这样的嘎嘎！
快点好不好，我要回家看吴敏霞	心情可以理解，总不能胡打结束比赛吧…耐性…
勾引异性的24种招式。你喜欢哪一招？你用过哪一招？	这些娃的表情怎么被引用得那么神似呢，keai
假如你跟别人结婚了，我会把这个快递到你家的。	吓死特拧勒。不用那么恶吧。结婚就能代表幸福了？
#设计宣言#：一组【设计师的血泪真心话】海报，你有同感吗？	每行都有不被他人知晓理解的辛苦。
外国农家小屋，仙境一样。	这叫农家小屋？是艺术品吧？那里的农居这么有设计感
追随你内心的呼唤，迎来新的一天。早晨！	这天气不是特别好啊！
#闲聊策划#这就是在日本要花80人民币一碗的拉面alink	新加坡也差不多这个价、60-70吧
这个学校碉堡了，你最想和谁同桌！（转）	蜡笔小新，哆啦a梦，路飞，樱木花道
能动手的尽量别吵你知道不	女人公敌大烂片！就这段搞笑
这是大象的腿和肚子	怎样才能打好一个控卫？
失独者在知春路计生委门口聚集	国家该高度重视、拿出实招了。
拍戏最难熬的是见不到我的宝贝儿子啦！	明星都把雪纳瑞养成犀利哥，真的好欣慰。
我知道那些你以为我不知道却知道的事。	是，我知道，而且再也不想知道了。
#昭苏之行#之我喜欢的照片----旗手。	谦哥，PP的像素不够啊，是不是该换点装备了？
★可爱的沙滩鞋，走过的地方还会留下小脚印哦。	好有爱的鞋。各种的稀饭。
地球果真好危险！石狮都得带头盔！咱还是回火星去吧！	Doesn'tlooklikePSed。Veryamusing
请教各位，吃红薯不会有毒吧？我每天吃得心惊肉跳啊？	紫薯是转基因，不要吃！
『明信片』我们走的太快，灵魂都跟不上了。	兽医：都是些失了魂滴娃呐。
唉。穷得只剩姨妈纸了，来来，赌一把。我压两片。alink	这什么牌子？见都没见过。也敢用？
作为一名伟大的吃货你必须知道的事情。(viaFATOOH)	#热门微博#alink哈哈，吃货就是小聪明。
7大全球性感酒店泳池，这个太cool啦！。你去过几个？	哦！要时能在这里游泳那该多好呀！
打个蛋也要卖萌？_！	我想说，这表情怎么弄上去的，，，
睡觉前玩手机，是导致我失眠的主要原因。戒不掉啊	好奇肥尸哥用什么手机呢？
满园春色关不住一个猪头出墙来。	睡前看见这只猪宝宝，甚是喜欢！
这位父亲太有想法了！	偶们木有选举，所以不能用这个创意！悲催啊！
100年后的iPhone，你会买吗？	先看我还是否活着吧
陈志武：中国到了非民主不可的时候了！alink	大家都读读，看看是韩寒对还是陈老师对？
看完直接崩溃了，居然没看出破绽！	10分×10分应该改为（10×10）分，一个同名替换的把戏，
此图一定改变你对乌龟的认知！	改变啵我对咸湿佬茄认识
我会告诉你们，又到了制造暴乳妹的季节了吗？	这个怎么讲？不懂。
中国移动急了。但是，这年头谁还整天抱着手机发短信呢？	接受短信的多，很少发。
大家都一再要求我换头像啊，大家都不爱泌泌了吗？伤心	终于不用以为自己关注了她。
【重口味慎点。】串烧肥虫，你敢吃吗！？	感觉好恶心，恐怖。
比赛第49分钟，博努奇在本方禁区内手球，裁判没有判罚。	为了比赛的精彩，裁判留情了。
今天下午出了什么大事吗？整个新浪微博可以用死气沉沉来形容！	你以为不用上班吗？我啊今天忙死了
开业我先试睡！求同睡，但不同房。摄于桔子水晶-北京瓷器口	不知道啥时候开业，就在我家对面。
妈妈说我爱摇头晃脑	有张头右偏很厉害的没截下来？滢姐！哈哈！
巧克力拉面，不知道有没有人尝过，味道如何。	这会是什么味道？甜汤面
人生为棋，我愿为卒，行动虽慢，可谁曾见我后退一步。	一旦跨过河，进入别人的生活，就需要横着走
大学生现在真是干什么都不行了！	我次奥小学生要逆天了么？！
【泸沽湖畔洱海】只愿生于此，住于此。	正在收货也是蓝色的哆啦A梦
夏天到了，教你如何改造自己的T恤，绝对大师级！	cool。这T必须经得住折腾…
一张图告诉你，12星座人生最快乐的事！「转」	发发微博叨叨叨叨叨
读一本新书，开始一段心灵之旅。	哇哇哇，我昨天也刚开始读。
总有那么一瞬间让你觉得杀人可以理解。	同意。终究来说人总是靠近魔鬼多些。
今天浙江高院判吴英死缓，和法治胜利没关系，和舆论有关系。	赞同。但是不排除以后会影响到法治的进步。
你若简单这个世界再复杂也与你无关。	是的，你简单了，你的世界就简单了。
拍摄美丽大学2化妆篇	姐姐好漂亮，加油加油、
啊哈哈，眼神已经出卖了你是谁！(눈_눈)转	不看眼神以为是桂喵
爱国贼，你们成功了。你们成功地让全世界知道了。	突然感觉他们是来潜伏的，高级黑……
#这不是我认识的黑板报#图片来自百度黑板报吧……	最后那个我怎么觉得在我们学校看过……
睡在我上铺的兄弟。周末阿黄和路就要走咯	原来这么这么肥啊。
【极度震惊！】这就是我们生存的环境…（羊城晚报）	作孽呀，太短视了。有管理责任的人不作为，百姓遭殃了。
83年的中国，有你的家乡吗？	曾经的中国，如今的朝鲜
突然心情很不好，我们都不在村里，留下爸爸一个人。	失去老人的悲痛需要一段时间来淡化，希望你节哀
去体检，医生无奈给了我这个检查结果。	介不偶的体检报告么！
看看她有多厉害。alink	奇才杂家！。犀利妞
话题：今天聊聊“肿”，你肿么了，你肿了吗。你哪肿了	肿了，就显得很呆滞。
手到用时方恨短啊。「转」	弱弱地问一句……干脆面是神马……
高清组图，你就不想说点什么吗？	真漂亮，这才是国母。
中国最美旅游胜地排行榜	好多没去过啊！要加油啦！
有用户在Facebook上张贴了这张照片，然后就被Facebook站方删除了。	手肘啊，很明显的啊，看错是错觉啊。
昨晚做梦一晚上，各种反省。	看来你老人家又犯错事啦
不按时睡觉，脸就会，像这样，掉下来。	胖虎将要超越的目标——仅限体重
#拿着相机摆拍的西藏之旅#摄影师的梦想只为挽留一处光	估计以后就直接找女朋友了
实在放松不了，就着倒霉天气，得次感冒吧。	感冒中，你就算了。感冒的时候，才会想念稍微健康
钟表，可以回到起点，却已不是昨天。	汕尾出事完到汕头。
木老师要是意外怀孕，你们怎么办	你生，我们买书养。
身为资深职业电脑玩家，这种事情绝对不能容忍！	我非常讨厌开机启动的东西，统统不要
明明喜欢的是你，却要装做无关痛痒的开着你跟别人的玩笑。	读书的时候经常做这种事情
这就是母爱与父爱的区别。	母爱如河，父爱如山！
得失随缘，心无增减，在顺境中感恩，在逆境中依旧心存喜乐。	在顺景中感恩，在逆境中自救
60条令你大吃一惊的小常识！超级实用，必须收！（转）	待用#热门微博#alink
一口气倒出9杯渐变饮料，太神奇了啊！（转）	没看瓶子越来越斜了吗？本来里面就是分层，黄绿原色
对鲁班的发明表示认可，以及积极意义alink	鲁班竟然发明了这么多东西！简直是家居界的逆天人才啊
真有这个App吗？（图片源自网络）	这个不错，以后不用担心城管突然来了
【提神专用】：第52届国际小姐中国大赛重庆赛区季军！(转)	想吓死人阿。怎么丑。
今晨4点左右自然发动，9点25分顺诞6斤9两小龙女一枚	速度呀！儿女双全！
我在台湾了！这次12项提名，感觉非常之兴奋！	恭喜恭喜，一直支持你
明天出发！别忘带东西，弟兄们！	怪不得人喊赵爽纯爷们纯爷们，是赵爽自己弟兄们弟兄们地喊
【大家来找茬】之央视字幕集锦。	这和法轮功好像没啥区别。
等个公交车不容易啊(转)	这公交车必须是水路两用的吧
据说好女朋友的标准：比男朋友轻40斤。你达到了吗？	90的女生，太多了吧！
喜欢这条尺子高腰裙，型。	真想有一张你的签名合影
好累。找个地方歇会！艾玛。	:好累。找个地方歇会！艾玛。[
【英国费列罗圣诞树】OMG！巧克力控，你还hold住么	缺少个人送我费列多
看到一个编程语言的图，呵呵，挺逗的。	C++的超级形象啊……Lisp的看不懂什么意思
女生，你为什么不沉住气奋斗？	女人最幸福的一生是人生层次不断上升的一生。
曾经以为，拥有是不容易的；后来才知道，舍弃更难。	曾经以为，拥有是不容易的；后来才知道，舍弃更难。
首届自媒体峰会我在这里:alink	你怎么总喜欢跑这样的会呢
与昨晚第一朵昙花开的时辰一致	和第一朵一样漂亮，今晚可要按时休息哟！
神吃货！美食竟然还能这样吃！给跪了（清华南都）	做过蘑菇蛋，不如照片上的好看。
新的一天迎来了新的流量。	昨天750mb流量今天直接重置了
同意这是酷刑的童鞋们请转走。我宁愿被揍也别这样啊。	太不行了，这样我会疯的
那些年，我们一起买过的“货真价实”	反映出社会发展的导向问题
这里是香港，美的一塌糊涂……#摄影#	其实香港都吾是好大！
粉色的立体家居，看着不错哈。	转走了，妹妹的房间就这么定了
晚上不慎误食澳洲牛排。好吃得不行，赶紧游泳去	上午还批过度捕捞？！
【午间分享】人类已经不能阻止日本人搞发明了。	那件婴儿擦地的衣服不错。
企鹅岛，先和公仔合个影。🐧我在:alink	企鹅岛是神马地方…
有过这样班主任的同学请默默转发。	靠！岂止是看过！这种戏码天天有！
连汽车都受不了北京的空气了！	没错！今天一出来我的车车也受不鸟啦赶紧出去躲躲吧
我又烧回来了。发烧弄得我根本睡不着，太煎熬了。	还是要多休息，刷微博只会更差吧
#赛场之外#打完总决赛，热火卫冕，你们宿舍楼都发生了些什么？	鸟人的第一只冠军戒指啊
江南style为毛突然就火了？alink	全球得瑟版江南style
男人有肌肉和没肌肉的区别可真是一个天上一个地下啊。转	男人有肌肉和没肌肉的区别可
就这张吧，前天刚染完照的	好厉害的速度，开始喜欢看你打球了！
据说每个人身边都有一个笑点很低的朋友。夜幕	看起来很像某人捏。
面试建议，后悔看到的太晚。	我要是面试官，遇到这种假惺惺的学生，肯定踢走
凡事不要想的太复杂，手握的太紧，东西会碎，手会疼。	我懂！只是放不下！
感谢你们一直都在，你们才是我们的骄傲！	努力拼搏赢得胜利我们永不放弃
今晚的＂vt葡萄酒沙龙＂，一半熟脸。	都在玩微博！这是喝酒？
那一年他们还稚气未脱。	欧文，杰拉德？！这图。
没有这锅＂黄油香煎马鲛鱼＂的寒夜，最难将息	流口水。好美味的样子。
0930话题：旅行中结识的伙伴	单身好男人又少一个了要幸福啊
才知道孔二狗真名叫孔祥熙	得了吧，他就一孔jb
方向不对，越努力，越尴尬……	没有方向。我从来没有。
收到可爱的手机壳，据说和我有点像？	可爱的手机壳，，和你有点像？
今天北京日出、日落时间。感谢上天！	潘潘有潘安的相貌，潘金莲的风骚。
美国媒体对于塔利班“单谈”还是表示乐观alink	美国佬不拍塔利班扣留人质。
（唱）：“我的家在东北，松花江上…”	你回哈尔滨了吗？海阳`。哈尔滨这两天很凉爽的很
演唱完毕哈哈好紧张还好挺成功	不是一般的成功，考虑出单曲吧！
【一张图看索尼PS4发布会】#playstation2013#	说了等于没说。跟苹果发布会一个尿性。
【金山快盘与T盘集成工作进度汇报】	都是sb，骗人的一帮lj。
不想伤心最好的办法就是假装自己没心没肺。	我就是个没心没肺的人。
妹纸不能光看镜子。还要脚踏实地的看路啊。	有时候路也不是走出来的
头发长了，束了小辫子，思密达！	真好看，哥哥留什么都好看，嘻嘻
前三名：吴莫愁平安金池我80后alink(chang.weibo.com)	吉克隽逸。我50后。
这个广告的创意是：让孩子的眼睛远离色情。	孩子的眼睛？谁能告诉我，从哪方面能看出是孩子的眼睛？
［小学生的请假条］。望吾师悯允！。	古文功底不错啊。中医也懂。人才也
东方姑娘她永远在我心里。#陈乔恩#	支持乔恩的东方姑娘，好期待哦
iPhone控们，洗澡的时候，也可以这样玩滴！	保持距离，免得靠的太近得近视眼。
36度1是怎么个体温啊	是男的体温不怎么正常哦。
我就不信这么早会有人点赞。	很多人早都要上学上课啦。
该图作者说了，若觉得分析有理，请转发。	他去爬总统府的水管去了
【一个奇怪的问题】如果IE可以吃，会是神马味道？	蓝色表示薄荷味，黄色就芒果或柠檬吧，整体怎么配才可口呢？
美到窒息的日本二十四节气摄影图，走进日本传统之美！（转）	用心感受生活才能留心身边的美呀
牛人合集。果断放弃治疗吧。(转）	为什么要放弃治疗。
一觉醒来，你家门口多了这家伙，说说你会干什么？！	爸你终于买回来啦。
你永远都不会知道，为你乱想的人有多么爱你。	乱想什么的，是热情还在
玛雅文化遗址，想起了什么彼此心有灵犀嫣然一笑	请把中国的外交放在第一位。
每日一叹：学会对坏人微笑。这一课，太难了。	我觉得能做到沉默，就已经是我的极限了
普通话和东北话听起来很好听。	什么意思？就是其余地方语言不好听呗
送你一个小太阳，转走他，愿你的世界永远是晴天。	每天牙齿都能晒太阳
这降价降的太坑爹了！诺基亚用户你们伤的起吗？	电信版的也就这个价，就是降到1000，我也不买电信版。
三十五本甄功夫。香港进口	我二舅和你长的老像了，我一看你就想起我二舅。
男人真是什么时候都改变不了好色的本性啊！	我不会告诉你小M戏里戏外都是gay
【老照片】1905年，大清新娘新郎。	新娘像鬼，好吓人！
用知识武装自己。大概就是这个意思吧。	ihavealotofbooks都是注会书。
预约请查看下图，并给我发邮件，谢谢。alink	发了邮件，木有反应，不会没收到吧？
居！然！还！要！全！部！念！一！遍？	他们搞不定啊╮(╯▽╰)╭没设计好……
把夕阳摄入蒲公英里面。	好靓…喜欢蒲公英…
趁我们年轻，多走在路上，多翻山越岭，多沐浴阳光。	博观而约取，后积而薄发。
长洲岛唯一按下的快门。	还是喜欢在我还是小孩子的时候的长洲岛。
【你能抗几级台风？】via：直播上海	我能抗10级台风，，看来肉也不是白长的
人类再也无法阻止老外包饺子了！	你妈的，用整鸡蛋仔的工具包饺子，犀鬼利
调查一下女粉丝：你们最喜欢的3个华人男明星是谁？为什么？	刘德华，刘德华，刘德华。符合艺人标准，做人，做事都很OK
我们躺着中枪了？敬告用户：大众点评不涉及任何用户隐私信息！	大众点评给我们生活带来了很多便利。
便秘了。整个屁股我hold住，全马桶看我一个人。	教你一招，用咖啡灌肠，立马见效
分享图片：吉隆坡参加亚足联会，拜访张吉龙代主席。	张指导对于陈涛登录意甲您看好吗
小宝贝肿么了，是失恋了还是被人期负了。	瞧它那可怜的小眼神。
英国BBC评出的人生50个必去圣地。有生之年，谁能全部走遍？	有生之年我想走遍它。
看到一个最悲剧的死法。	额。果然是鸟大了，什么林子都有啊。
【3分钟弄懂中国金融体系】钱是如何流动的？（易胜网）	解释性文字没有图表做得好
整整一年了，如果可以的话，托雷斯回家吧！	回你mb。我村小，养不起这尊大菩萨。该滚哪儿滚哪儿去。
水滴——微距下的美。alink	水滴—微距下的美！
我国人民币存款首次突破百万亿元大关，人均存款77623元！	我的那77000呢？谁帮我存银行去了？我急用，帮我取出来吧
看发型就知道这哥们是厅级干部。	平时没少贪污、腐败、玩女人吧？瞧给累的。这又是开什么会呢？
瞧瞧这狗狗的衣服设计的，好欢乐！	好形象好可爱的狗狗
【吧友爆笑吐槽台湾LOL的英雄叫法！】给跪了！（仅供娱乐）	其实我觉得台服的更贴切呢，这个黑的毫无道理，有点吹毛求疵了
#Tango一日一画#猪八戒的文艺生活。	这微博，基本是打开你的主页才有幽默，小欢乐的安慰……
自己卤的茶叶蛋，家里只有龙井和峨眉雪顶。	成本？我只用茉莉花茶卤。
【艺术生】与【理科生】的区别。	【艺术生】与【理科生】的区别。
把答案，变成你喜欢的样子。（via伟大的安妮）	把答案，变成你喜欢的样子。
不喜过年：因年末节日太多，越发显的寂寞。所以，讨厌。	飞姐你的歌啊不寂寞我们要爱自己呵呵
求柳如是的下载链接……	很早前我就下载看过啦。alink
人类退出后的自然。（449x600）	天地不仁以万物为刍狗
银魂国语配音第1集alink	。配音完全是渣啊，神乐的声音完全不符啊
【老照片】1937——1947年，远东第一大城市，上海。	那会什么香港，马尼拉，东京统统都算不上，唯有上海！
若无心事挂心头，便是人间好时节	终于说了一句我认可的话啦
不扯吃喝嫖赌，咱们单说吃：泰式虾与鸭肝两种（煎、抹）	晚上你不发吃的你会死哦
老娘终于又把盗墓笔记看了一遍。	又一个盗墓笔记的迷呀魅力好大啊看来。
据说冬瓜头quit了？去哪了？	又谁说的，我回去查查
其实最好的日子，无非就是你在闹，他在笑，如此温暖过一生。	真想就这样，简简单单，闹着，笑着，温暖过一生。
我的脾气赶走了很多人但留下了最真的人	人生真理，哲理，文字控图片控-STUFF快快关注我吧
在微信上看到一篇耶鲁大学校长评论中国教育，微博上有吗？	这条早就证明是假的啦，自己动手百度一下啦。
超好听，陈奕迅唱陈百强噶歌——《等》alink	等一个心甘情愿死心塌地……
起床了。起床了吗？	工业化时代____大炼钢铁！
逛贴吧被这个签名闪瞎了。「转」	尼玛。看久了真的会眼瞎的睡觉睡觉
比赛结束，各位开始吧。	上次半夜起来看你比赛输了，这次又是，拿我开玩笑啊。
不开心了就对生活大声说一句“FUCK”！	大家不开心，就一个say······
天然刺猬刷，喵星人爽歪歪。（转）	꒰⌯͒•·̫•⌯͒꒱
其实没有理由不去快乐，加油	总有那么几个人把你疼到骨子里去
（转）今天看到一个央视节目的投票。	敢痛内牛啊。此漫画说出了在下的心声。
据说反日的已经开始在砸相机了。	有本事，去日本砸！
温州房价暴跌每平米降2万专家否认楼市将崩盘alink	哪位专家啊？怎么总是专家没姓氏的啊？
这是天冷了还是哥发烧了，咋一阵阵这么冷呢？	峰哥注意身体哦，千万别生病了！
热情洋溢的粉丝。感恩大家的支持！	我刚从威尼斯回来，你就去了。太可惜了
感谢那个带你进入微博世界的人吧！你还记得ta是谁吗？	王老师，我第一个关注的就是他
牛刀：中国未来房价基本走势的分析和预测alink	中国的刚需太猛烈，狮子口太大，这一代估计喂不饱！
Bq红人榜颁奖结束。得了两个大奖！乐下！	您应得的，恭喜武哥，难忘03年大连的相遇。
说一下，你这辈子最认可的理念是什么，如果你有思考过的话？	成就他人梦想就是自己最大的梦想！
我不想评论了，你们自己看。	呵呵，这可是能要人命的！查！准有王宝森！
从前，有个人，他不喜欢我，后来，他死了。	很喜欢这句话。哈哈。
看了几篇微博就能爱上一个人，是有多蠢？	这叫做致命邂逅。命运最终最都会让真爱相逢。
金.凯瑞大叔在最近一个派对的打扮，重点是脚上套的那货哦	穿上这鞋子没人敢乱踩吧，
牛人BeatBox帝，4分钟表演完整个hip-hop历史alink	瓦哦，这招肯定很瘦脸吧
#少年派的奇幻漂流#比阿凡达还要美的画面。	李安的新作。嗲！豆瓣评分好高！感觉又要用生命去欣赏了。
踢足球的男人流眼泪都那么帅吗？踢足球的男人你怎能不爱？	踢球的男人怎能不爱？
「甄嬛传」把女人的这点心眼儿算是给写透了。	骆老师，书和电视剧还是有很大差异的。
你以为你在合群，你是在浪费青春。(来自：人人网）	不完全认同！但凡事要有自己独立的空间，想法我同意！
在淘宝上买了20张彩票。就等我中奖之后报复社会吧，各位。	基本没戏，我就没中过
在中国陶都陶瓷城，紫砂壶的价格越来越看不懂了。	本是日用佳品，把玩雅趣，现在却成了沾满铜臭的俗物。可叹！
已过零点，跟自己说一声。生日快乐	哇！生日快乐，美丽的天秤女孩！
(2/2)回忆增加光彩和亮色。	半夜还发这些哲言，好去睡觉了任总！
我是姜武，祝你们好！我准备好了，来吧，都问吧！	怎么让胡子更浓更密啊沫什么东西还是先天基因啊
要命，刚知道忘忧草就是黄花菜，my世界观……	这。额的世界观啊。
废了！真要一个人在北京过节了！	兵哥中秋快乐。不管在哪都一样。快乐安逸、嘤嘤。
清洁工阿姨，你让我们情何以堪呢？	HneryFord说过：最好的公司就要给员工最高的工资
喝杯红酒，看电影，忠犬八公，感动	我也看过，很感动！
。陌生又熟悉。《类似爱情》。alink	喜欢爱娃的歌每首都有感触
天津大沽南路有游行，打着横幅，喊着口号	天津最近游行颇多，肿么了？
刚收到的新书，抗日英雄白崇禧。值得一读，还原许多历史真相。	国军比较文明，枪口只对准日本，不会打自己人，gf就不一样了。
想一千次，不如去做一次，华丽的跌倒胜过无谓的徘徊。	自己不去体验永远不知道是怎样。
在哥大演讲结束，一篇报道;alink	作为小辈，非常欣赏您，向您看齐，加油！
7月13日（周六）入伏。但，是不是有人感觉已经入伏很久了？	上海等南方地区不是一个入伏标准吧，一直是伏啊
老毛给老蔡照合影。我借机把他们都照上了。	任总，你还真可爱。顶你
高级分析师把精算助理牵走了，祝福他们！	是同性还是异性。？
人生是一种承受，我们要学会支撑自己。	有体会的人才明白的道理！
以后看球只能在现场，电视无法传达身临其境的感觉！	这种事还是不要拿到wb上炫耀的好！照顾一下劳苦大众的感受吧！
对今天越不满意，就越怀念胡耀邦先生。	这位老人，很多年轻的朋友感到很陌生。
豆瓣上看到的，这真的不是神经病写的么哈哈哈哈哈哈哈。（转）	这是人类历史上第一次无产阶级运动吧
尤尼斯下！15号阿里上！咦？又是阿里？这次不是赞助商吧？	阿里巴巴卧底赞助伊拉克，派出影子部队
配合的音响系统听过黑胶的声音后估计旁边的CD会很少听了	又是一个周鸿炜难道有两个不成。！
出门“旅行”必备，粉笔。话说这是吐槽，莫喷。	这群sb，我要遇上就问他们为什么不卖装备
大家都在看#中国好声音#吗？一起来聊聊呗。	第一次看赶脚自己好奥特
广州恒大赢了球，心情大好，给太太买宵夜去。	你老婆一定很瘦！发挥你的联想吧！（内涵）
这些画面的故事，用了十多年去写。alink	没有GDP，也没有现在詹姆斯！时代的终结，永远不变的是怀念！
今天空气质量。注意：环保局和美使馆日期不同。	为什么魔都空气这么好？
到年底一总结，发现赚到的只有年纪。	越活越年轻才是硬道理
It'sUS。mycrew-这就是“我们”。我的全体队员们	那个小儿子和韦德长太像了
屌丝是些什么人？（图：搜狐财经）	感谢程序员帮忙垫底
俄国司机干交警司机的脑内活动:“fuckthepolice”(GIF2.1MB)	俄国司机干交警，好凶残啊。
“法律的生命并非逻辑，而是经验。”——OliverWendellHolmes	这也要看是在哪种法系吧
牠叫贝克汉，刚吃掉了六百块钱新台币，正在诚心诚意地忏悔。	我家的2B今晚吃了30人民币，8点20分左右诚心诚意打了嗝
#随手拍#真好，从小取向就正常。	听说很多都是长大后才变的。
教你怎么轻松拥有六块腹肌！	而且最重要的是饿了还可以吃
爱若无法抚慰彼此，便不过是喜欢而已。───张小娴《相逢》	爱若无法抚慰彼此，便不过是喜欢而已。
#早安发吃#送给正准备吃和没有吃早餐的童鞋	印尼炒饭啊，好想吃
历史，请记住这些警世名言	全是心黑脸皮厚大学的高才生
这张图叫做：千万不要相信中分女生的脸型。（转）	圆圆胖胖的不是挺好的么。
脑子越洗越干净，洗到最高境界，本来无一物，何处惹尘埃。	再来一部搞笑的电视，发挥你聪明的大脑袋
来杯蓝天白云呗。喜欢的转一个！	不错，就是蓝色有点难过。
麦当劳创意户外广告，震撼。！	才发现其中的奥秘
你是否很是怀念这段岁月？	扎辫子的小姑娘好可耐！
2012款T恤新鲜出炉喽！晒晒我们的福利	求T恤。要是有网址卖就好了
全面征集春节搞笑短信，直接回复即可！	你们好啊！回复的好快啊！
满清十大酷刑里应该加一条:降温期间停暖气。	最大酷刑是晚上钻被窝的时候！
最浪漫的事——和你，看雪，亲吻。	肯定是跟人类学的！
问俞渝你曾迷茫过吗？答：迷茫不是坏事，你可以拥抱迷茫。	当有一天我很成功了，我也可以这么说
小时候，幸福很简单；长大了，简单很幸福。	最终我只想过简单的幸福生活！
老爸，不跟你玩儿了……	哈哈哈，好萌啊，好像养个女儿。
书房终于收拾好了，书不多，刀不少。	好有感觉。！哈哈电脑桌凳子啥样？发一张看看？
贝克汉姆在济南【全文】alink	这篇真心无聊了拉低了你帖子的质量啊亲
视频仅10秒。反映学生一天的生活。alink	我一天的生活，，，开始了，，，
煤气罐配送站的工作人员，运气都不会太差。	那烧锅炉的师傅们，火气会不会太大？
木老师要是意外怀孕，你们怎么办	都别瞎猜了，怀孕？已经成为历史了，大家可以放心去吧。
江苏舜天0：0仙台七夕，打出气势，打出血性。	得势不得分那。看了最后几分钟的狂攻，挺有希望的
最强“台湾女”求职视频疯传网络比柳岩更拉风alink	让你上班真是屈才了
人才呀。居然挑了个风景这么美的地方吃晚饭……	快回家，安久的脖套还没卸下来呢
见过二的，没见过这么二的，“我喵。喵勒个去。”	见过二的，没见过这么二的，“我喵。喵勒个去。”
管你妈左派右派，吃这个么？	您能不能别这个点发这个。马上要睡觉了吃也不是不吃流口水。
难得星期天可以待在家里。	嗯，好好休息，莫莫，你很辛苦。养好自己哦！
嘿嘿嘿，力气依然不错。一斧头可以劈开这根木棍！	在地下室能中枪？还是中导弹？
【早安】知道而不显出，是一种修养。	这也是成熟的标志之一。
<<国民旅游休闲纲要>>今天颁布实施了。	顺应潮流，旅行已成为人们越来越重要的生活方式！
两代读者。（助理代发）	老郑，你手酸不酸啊。以后限2个小时
诶？诶？喵星人！快说出你来地球的目的！╰(*°▽°*)╯	求互粉，互粉必回，在线秒回。……绝对不删。
一想到明天的工作量，我就想逃亡	需要帮忙的话就说一声、
在这片山里，联通一去不返，电信气若游丝，移动活蹦乱跳。	村通工程，凝结着移动人的艰辛和汗水！
反正也没事，谁来聊十块钱儿的？	王局，我没有信仰！你给我指个方向
听10秒就会喜欢上的歌曲。下载来慢慢听。！「转」	已经落伍好久了，先收着慢慢听。找首好歌不容易呀
#重温微博#【在即将过去一年里撼动我的视觉记忆11】	被这张图感动了。另，只拍摄物质上的美丽，那不是摄影的意义。
简单，直接，粗暴。片子里还有打酱油的。alink	把100多万的GTR和草根比，看来按照价格排列就基本没错。
有这样的老公真是幸福啊！	能做一半就算不错了
巧克力能随便吃么？豆包妞妞问。	小孩子不可以吃太多甜的哦。
嗨，女孩你听着。（via：朱小凸）	为什么我觉得在这里恋爱好像才是女孩的梦想？
加湿器一直对着我喷雾器，我感觉自己跟仙女一样了	我认识一家精神科不错的医院，，
有个哥哥真是太好了，这一幕实在太有爱了。	呵呵，真可爱的BABY，么么
人生四苦：看不透、舍不得、输不起、放不下。	图美、文精。学习啦！
这么消魂的地瓜你见过吗？	大千世界，无奇不有.
在家里吃的饭才叫吃饭。在学校吃饭纯粹就是为了生存。	记得曾经一起吃完校食堂后拉肚子的日子吗？
据说北京地铁电视系统被黑了，所有电视只显示“王鹏你妹”？	盖报纸干啥，关机就行了
【日本老师教英语！笑死了！】alink	日本仔真系唔适合讲英文啊！
陆家嘴男和张江男的一天	Dota毁一生，网游穷三代。赶快买彩票，个个高富帅。
#郑在晒早餐#不吃早饭易患胆结石。要吃早饭。你吃早饭了吗？	坚持常发早晚餐图片噢乖
装备美国海军的MQ-4C首飞	习总:命令二炮发个东东把它给打下来！
注意看第19秒，巨牛，笑死人了！alink	19秒的确牛，小孩小心点啊，哈哈
世界上10家最美的书店--华丽的精神休憩处	书虫在哪儿？偶要去
刚才听说现在最得瑟的词是“井”——横竖都是二。	你Out了，很久以前就在用恶劣
飞机上拍摄的英国伦敦，打开窗就能碰到云了！｜	呵呵，如果你飞巴黎戴高乐，可以看到埃菲尔铁塔的顶端的
食物的力量。太强大了。太强大了。	简直是舒哥的化身。
人言“性格决定人的命运”，殊不知“性别决定脚的命运”。	对于脚来说，穿高跟鞋和坐老虎凳差不多。
创意门，平移下来就是乒乓球桌了，赞！	典型的骗子，漏洞百出了吧！
站在我们中间的是谁呢？嘿嘿：）	哇！一行禅师亮了！
【快讯】凤凰卫视刚刚报道，称白俄罗斯向斯诺登提供政治庇护。	搞的和江湖大片一样
我是真心喜欢这张照片，看10次笑100次，太可爱了	真想看下他的正面是怎么样的
如果不学金融，我想做个导游。	如果不学会计我想做个园艺师。
男友他妈的妈见到女友他妈的爸应该叫什么？（转）	七楼，然后彻底晕了。
这才是街拍！——VictoriaBeckham贝嫂抱小孩的功力太深厚了。	也不怕把孩子摔着。
碧螺春是这样炒出来的。吓煞人香！陆巷。鉴山堂。	大部分绿茶都是这么炒么？
主银，救救我啊！过节吃太多了。帮我翻下身。	它身上怎么好象有血
第一次玩立体游戏，好刺激！alink	用的电脑是未来人吧？
他只贪污了六千万，你相信吗？	听裆的话，裆说多少就肯定是多少。
平时不行善，回京大雨灌。	平日不行善开网电被断
时代三大装B利器：苹果手机、单反相机、微博加V。你还缺几样？	一个都木有，三无人员
唉！这状况等还是不等呢？	露宿排队！比苹果还热
我正在努力变成自己喜欢的那个自己。	以美好的心情，做最美好的自己！
猫爪控的你们在哪里？。	看得我心里痒痒。。
鱼总威武啊！这得让人家多怀念。	我买了让湖人分8雷霆一定要拿下噢
这这这……真的舍得下嘴么……	下不去口，只好留到长毛，哈哈
#诸葛暗系列恶搞走红#麦库也来凑个热闹，一切尽在不言中。	不能说的秘密，麦库替你保密。
晚上做了一道白菜抄月饼，这日子过的太凑活拉！	啥馅的？五仁还是蛋黄？
#看图猜电影#哪部电影的剧照？	Heisjustnotthatintoyou
微风天，蓝天白云。莫非因为好多工厂已经停工？	广州难得好天气啊，希望过年都可以见到蓝天白云
朋友养了一只野猪当宠物！(转)	野猪还特么穿衣服！
不靠谱，这已经是第四次回应。靠造谣吸引眼球很无趣。	额，这让小川总何去何从啊
8块5毛钱让所有人流泪！	为母爱而感动，为国家而愤怒！
新的励志哥！00后太狠了！（人人网友）	尼玛，太励志了吧！--。
今天和这条很乖的狗拍戏	其实吧，狗也在说:今天和这位很潮的阿姨拍戏。
枕上看山山未醒，闲云已过古塔东。	山未醒，云已过古塔东了.
iphone4待机半天电放光是电池问题还是软件问题？	后台软件开太多关一些试试哟
一边参加「我是老歌手」，一边刷几块钱儿的，靠谱吗？	多老才会是老歌手？
昨天被城管追，好险。	这样看谷歌眼镜可能不会被允许这里卖
有微博称，这是美国高二的数学。求证！	等会儿给您发一个GMAT的数学题瞅瞅
#没品图#不信谣，不传谣，不造谣。——net	这个图是对没品的一种侮辱。
朋友们早上好，今天的空气质量。	北京空气质量差别太大了
【8月13日16时要闻回顾】alink	另几个还不如这个呢
让空姐接管人民政府吧。只有她们知道什么是服务型政府。	不如让小姐管，她们效率高！
摩纳哥准备了一份重要的报价收购博阿滕。	今儿是咱米兰首次赢得欧冠的日子哦，值得纪念！
QNMD……我就是喜欢钢铁侠！哈哈哈哈哈哈哈	我就是喜欢钢铁侠！哈哈哈哈哈哈哈
这个带幼女开房的、狗娘养的校长，现在哪里？	没收作案工具，阉了他
冬季的西湖，“景在城中立，人在画里游”	靠，曾哥，咱俩一块去！
据说是衡水中学的楼梯，这些公式你还记得几个？	以前要是我们学校也这样，估计清华北大我也能上了。
无法访问Gmail。请检查您的互联网连接或公司的网络设置。	谣诼，看了这条微博我试着登录gmail，没问题啊！
小点姐姐的萝莉粉一枚（萝莉旁边那个大妈的眼袋好重啊-_-|||	哈哈哈大妈你的眼袋好重啊亲！
呜呜这个名字真的大丈夫吗	最近正在拉肚子，，看见这名字，肚子又叫了
如果能看懂，说明你已经老了。#团800团创意#	额仙剑客栈I'moldman
电脑前的姿势……不定时的更换着……	龟式人鱼式寿司式贵妃式……
出去走走，别让坏情绪迷乱了世界，慌乱了心。	如此晴得星空很少见靓又有点神奇
【趣漫画】这个世界的真相……alink	明明是吐血的霸王龙…
为什么我们越长大这句话就越难说出口。	憋了好多年却又没说出来
设计灵感原来来自这里，难怪看着那么眼熟呢！	最恶心的是完全穿不住气质还在红地毯上舍不得走
看球的同学们今年夏天的课程表出来了！	德意志翻车老，荷兰意大利
美国女婴与小猩猩结为好友两年后重聚！很有爱呦！	Friend过打Band！唔系！系Friend过揪Bananas！
《天注定》首映结束，象一个孩子的出生。戛纳夜深，又喜又悲。	孩子能健康出生已实属不易，希望能平安长大。
我情愿和你化作一团火焰。啊。啊。	宁波人民发来贺电……
【治愈图片】听说笑容是会传染的，看到这幅图你微笑了没？	#敏捷个人##快乐#一下
我在观音桥宵夜，辣的好正宗，鱼香肉丝诶………	我在流口水了、呀啤酒、干杯。
一句话证明你看了「中国最强音」。	。好看，羽泉拿到了冠军
尽力做好一件事，实乃人生之首务。(BY富兰克林)早安，各位。	从今天开始尽力做好一件事——减肥！
巴西。巴西。巴西。给跪了	排名20开外，照样血洗世冠军，这就是巴西！
卖了2000个移动电源，挣了一千块钱，你高兴个啥啊	是不是线上推广引流，故意做薄利的啊？
正常胃黏膜上清晰可见的胃腺开口	人体内的器官看着蛮恶心滴，医生们很了不起。常常研究尝尝看。
ID里带公司名或者职业title的都是傻逼。	我觉得信这句话的才是傻逼。
早各位，还有三天就周一了	啊，为什么，就连我期盼周天这点希望也要打碎吗
换本杂志看世界。Bl00mbergBusinessweek登陆香港。	唉唷，刚好在听Jay的歌，好广告，好杂志，好香港！
穿上它，明天挤公交去！哈哈哈！	地铁都上不了，警察叔叔就请你去喝茶了
合作中，坚持不要应得利益的人，请慎交。	这句话我理解了，知道了，明白了，记下了。
突然想学做拉面。哪里能学？	甘肃很多农村都有对村民的培训！
早！猜猜她们在说什么？	右：听阿姨说你像赵丽容
淡定哥在过山车上接电话。，太强悍啦。	真不知道，他为什么要去坐这个
如果这些美男是在你家，你会有什么反应？alink	我估计我会兴奋死。
第二战顺利！下午第三战lyn我会全力以赴！加油！	希望能把打鬼队长干翻
＂猪和小鸟，冤冤相报何时了？＂	愤怒的小鸟！真神奇！有人甚至联想到植物大战僵尸！
女生都会想要这样的男朋友吧。「转」	这样女生，早晚被人拐了都不自知。
【趣图一张——“三个青年”】	普通青年，文艺青年，2B青年？
【度娘你知道太多了】	真牛x，百度啥都知道！
又到了吃炒栗子的时候了，一样爱吃的童鞋自觉举个手！	恩恩非常喜欢。等着同事回家给我带。
买机票，返现金，明天开始。今天打算买机票的童鞋，你懂的！	哈哈，小编该被粉丝骂了
我周末从中国回国之后，我们的猫特别高兴！老陆	老陆，是个有爱心的男人。
《画皮2》三大多余：绍峰、杨幂和3D。	妖的作用就是舒痕胶，且那时陈坤已瞎
看到最后笑得我眼泪都出来了。	什么意思啊？没懂--
妹妹，终于到了我们的年了，来！合影一张，留作纪念！(转)	哈哈，果然长得很有亲戚像，呵呵
各种不想起床，你是哪一个？(图转)	以前招财在的时候，我是最后一个。好想念我的招财啊
好想有一台介样的自行车，实在是太酷了。	这个有的，我看电视上
伟大的妈妈节日快乐！妈妈我爱你！	苗姐，晚上好。还看看你
看一次笑一次。二逼主人的狗是这样吃饭的。	这是狗的聪明，还是人的聪明啊！有趣！
深情款款地给前任写了一封情书，希望他能看懂。	字不错啊！特别是每行第一个！
阿拉善会员参加的演出。呼唤环保，回归大自然的美。	任总，宁波的px项目您怎么看？
有多少童鞋不知道今年没有大年三十？	放假前室友无意说了一句，当时我惊异了半天，呵呵
研表究明，汉顺字序并不定一影阅响读。#轻松一下#	你今天受影到响了吗？
左手ipad，右手星巴克，这就是时尚。同意么？	时尚的是她的身材吧。
曾经以为王母娘娘是玉皇大帝老婆的童鞋请默默转发。	那时就有小。？那个字是什么我不说
天天锻炼，今天总彩排出力了！	好给力的背影········
「QQ显示iPhone在线」在淘宝热销。	去年就听说过，虚荣心作祟
最近妹子钞票老是不够用，于是她就自己动手画了……	清明快到了，可以派上用场了
企业家也上场了。伊春市长也劲舞。	伊春让我想起前几年掉了一架飞机摔死不少税局的条子
给你的bra再穿件外衣就不怕××啦哈哈	好神奇啊！哪里有得卖？
你有去华尔街的资格么——MorganStanley面试	自己选择的路，跪着也要走完
既然买了骷髅，没理由不这么玩一下（via复生者哔哥Abomination）	才不想要那么骨感呢好不。
各位早，一周当中你最讨厌哪天	周三，课最多，最难熬
大家都去抢冰箱了！快走快走！晚了就赶不上了！	下周活动是不是冰箱！？肯定是！
小潘不让照。一边化妆一边发微博。	潘总要拍微电影，继续拆蛋。
问：拍樱花怎样拍出日式风味？答：把路牌PS成日文。	你妹的，真是洋气啊
段子手们行行好吧，不要在广告中植入段子好吗？	天才小熊猫是吧。太恶心了，我受得了广告，受不了段子里插进去
512，遥祭死于地震地豆腐渣工程的同胞！	当年看到这张照片心在滴血！
#樱花时节#2012樱花导览图，是不是有点武大的范儿？	介个地图好，收藏一下
【睡前放松】那些年，爱抢镜头的老师！笑到腹痛。alink	sofunny。lifereallyneedsomecomicalthing
世界如此之大，我却能幸运地遇见一些人。	世界如此之大，我却能幸运地遇见一些人。给我关怀，给我爱。
重申一遍，我还是支持捷克队，今晚胜葡萄牙，3：1。	我真的不知道捷克队拿神马来赢球？
这些二货可真能玩。	真会玩不过及时弄灭应该没事
央视：日本富士电视台派出直升机搜寻我海监船，但未找到。	海监船成了潜艇了！
一会儿把这些tiles都吃掉	主页君是个吃货，鉴定完毕
所谓的“坐骑”一定要拉轰。	所谓的“坐骑”，一定要拉风。
M蛋。你看看人凯尔特人，眼见都拿下第五场了。	真心佩服凯子的精神！
所以说，不要随便在网上公布自己的照片！大家都会PS！	长的好像那个小胖啊
厄、、出门前给大家演了一段独角戏：alink	不要用桶面本身的那个桶上面有蜡不要吃那么多辣椒听话
帕托和芭芭拉这两天正在意大利著名的Puglia地区度假，出双入对	改姓贝卢斯科尼入赘老贝家吧，球就别题了，专职陪老婆度假。
中国是法治国家，任何公民的合法权益都受宪法和法律保护。	您这话说的。我都不好意思假装相信了！
唉，想不到这个年居然是和韩寒方舟子一起过的。这个闹腾啊。	这俩人，特别是放舟子，很无聊
《以微笑待人》夏迈说：｢少说多做，以微笑对待一切人。｣	少说多做，以微笑对待一切人
Chromebook，看起来跟什么东西很相似，但就是想不起来。	好眼熟！但想了好久就是想不起来在哪见过了！
父子对扇耳光，36秒开始儿子王者风范alink	这大嘴巴子抽的.啪啪的。
很少见到这么有公德心的人了！	抽烟的同学们要好好学习哦！
什么叫印度“甩”饼。	阿三干的都是技术活
所以，我最近是和“女神”俩字儿杠上了是吗。	第一次离女神这么近。
神探亨特张，“块肉余生记”+“清明上河图”	六哥，访到卡梅隆大叔没有？
简单的几笔，告诉你一个人生道理。（图片Via网络）	找到平点才是最高处
柜子改造计划。改造完后的太惊艳了啊！	惊艳哪里==那块花布无敌了。
“我就是一只鸡而已，不用那么大的阵势对付我吧”（转）	只为保留老虎的野性，弱肉强食，我们俨然相似
叫一声笨笨，看似撒娇，实则御，杀伤力大大滴。	哈哈。红烧肉！肉肉！
鲜血什么的，吐着吐着就习惯了	鬼子不是连重水都没搞出来么？分离机么。鬼子有这么多电么？
我是那种，别人给点温暖，就会感动很久的人。	我是那种，别人给点温暖，就会感动很久的人。
女性与书，无法自拔的令人着迷。	关键是女性，不是书。
皇上陈建斌今晚是大秀才艺啊，唱歌、吟诗样样通！	曹操比皇上牛逼多了
马上就要出发去比赛了，四强面对三对韩国选手，拼吧	加油呀。支持你滴。
22号。人说此十几平米，你曾屌丝半年。	言语中意有所指如同画作看不懂才符合中国人的审美观！
开车的正能量，看几遍都不烦。alink	俄罗斯的行车除了火爆还有汗颜的温情，壮汉是亮点。
缘聚缘散缘如水，背负万丈尘寰，只为一句，等待下一次相逢。	很难有人超越陈晓旭演的林妹妹了！她就是黛玉，她就是经典！
回忆如墓，淡薄如素，我们是否该相忘于江湖。	回忆如墓，淡薄如素，我们是否该相忘于江湖。
小米2VS魅族MX，外观对比！	小米外观真像MX，各种仿
色彩斑斓的cinqueterre，悬崖上遗世而独立的五渔村	这色彩真舒服，住这种房子心情贼好啊！
#微盘一周岁#我的一周岁生日蛋糕，一起分享	好想吃一口！生日快乐！
酒店、KTV、网吧等要订阅党报！	白云，白云，我是黑土，报告：村头厕所没纸了！
一道菜的力量⋯2月6日lovelife孙子计画！alink	孙子给奶奶做的吗？
《耀邦同志第一次面对被拆迁群众——谈谈住宅问题之一》全文	胡耀邦总书记是中国的良心！
今天新浪微博对什邡的尺度空前的大啊！删帖不是很多。	想想四川是谁的地头，你就懂了，针对性太强。
一组超酷的家装密室设计。	倒数第6。瞬间脑补机器猫
我发起了一个投票【bartonorbutt？】，地址：alink	当然愿意了！来点刺激的！
所有你乐于挥霍的时间都不能算作是浪费。——约翰•列侬	只要自己开心就行了，不在乎时间是怎么度过的
史上第一个被尿戳死的人，这人是有多悲剧。	飞机喷出来的都是雾。
这才叫气场！鲨入无鱼之境.	。不管什么东西游到中间鱼群都会这样的
只要瘦，什么都百搭，要是胖，什么都白搭。「转」	太像了。话说tom有微博吗？有的话叫什么？
看明白这个图片，你就明白了战略的本质是什么？	厉害，那么关注细节，都注意到了图片里是小黑人。
别人再好，关我什么事；我再不好，关别人什么事。	你就是你，我就是我。
统统吃过的，恭喜你！年纪不小了！（转）	有几种还是木有吃过
体验克拉玛依的秋，这就是北国的风光，无限好！	是这样的，美到处都有，要有发现的眼睛。
#看图说话#：自从有了宇宙真理，宇宙最美就产生了！	自从掌握了宇宙真理，各界的马屁辞也愈发宏观了！
还是网易才子多啊！	要记得这是“看题”作文··
俄罗斯莫斯科的电线杆子。	好有爱…可是评论的说这是假的？
【调查】你会考虑购买新一代iPad吗？alink	内心有种名叫感觉的，它告诉我叫不买！
听说要建六艘航母，第一感觉就是要加税。	第一感觉是前五艘是哪五艘……？
总有一种冰棍在你的青春里留下过痕迹。「转」	冰棍……青春的记忆
有创意的前端开发工程师招聘广告。	这个点点前端是不能new出一个新的来的。它并不是一个function。
看到这张图，你有什么启发？	圆滑的人比普通人混得更好
它是该叫helloA梦呢？还是叫多啦kitty吖？	额，合体了？这是两只猫生出来的？
不要和我比懒我懒得和你比！	不要和我比懒我懒得和你比！
蛇在X光下吃老鼠异常的美感#GIF#(2.3MB)	这个，它吞得好快…
奥运开幕式，我来了	加油，期待你的精彩表现
#快讯#奥巴马获得大选胜利！其最终得票过半成功连任！	我喜欢奥巴马的人格魅力，自信、有力量
【《情感专家不靠谱》文/暖小团】	你不玩爱情，爱情也可能会玩你
习大大今天上午去了某大学，第一次哦	这不是在大学好伐。
回锅肉做滴不错，可能与猪有关系	主要跟人有关系！哈哈哈！
有枪战，有兄弟情。一篇危机四伏的漫画。「by：大象ROV」	哈哈，快睡觉了看到这个，哈哈！
琢磨先生脱口秀：《少年PIG的奇幻漂流》	这个拍成电影，绝对能拿奥斯卡奖。
再见北京，感谢伊拉克大使馆工作人员的那杯热茶。	你去哪里了？什么时候回啦？
炸茄盒，肘子肉，炖排骨，一碗饭就吃撑了，好悲伤……	你对得起西部还在吃草的人民吗？
偶不是狗，伦家是灰机，起灰。#狗##趣图#	这灰机加太多油了吧？
法官大人，这两个人其中一个在撒谎！	法官大人，怎么回事啊。
这就是传说中的围脖啊。	磊子。晚上加油哦。
动态图：百变椅子。	神奇的事情发生啦！
天气这般阴沉，大雨快点下来。最好风雷交加，荡涤肮脏世界。	形影相吊，若有所思。
中华民族已到了最人心惶惶的时候——星期五的下午5点。	放学了，结束心慌意乱
华夏遍地坟，杀光日本人。我似乎看到漫天毛毛	如果只是这样爱国，中国的希望还有吗？
明天回广州了，哈哈哈，三弟给大家弹一首	汗。我们的大中锋苏伟大哥还会弹琴？
赫。时尚易逝，风格永存	一直被模仿，从没被超越过
浙江亿万女富豪吴英案二审维持死刑原判alink	这太可怕了。此时彼时低调啊淡定。
杨浦公园里最经典的还是大象滑滑梯。你玩过伐？	玩的，上次陪聪聪去还抱着他一起滑呢
终于知道萧何追上韩信的真正原因了！「via_-冰翼-_」	。这个难道是遗址么？
越长大，发现能信任的人越少。	是啊、。因为那时候很天真。
这世界上安全的鸡，可能只有鸡巴了。	那可不一定啊，没准还有性病的呢
继续在iPad上练练字，写一个与天气有关的成语吧。	恭喜发财，起步价8块
如果心情郁闷到连做甜点都无法缓解，我该怎么办呢？	去洗个冷水澡，大叫一番发泄出来！爽啊！
如果每爱一个人能给我两毛钱……	爱冇竹席爱档发一条能得五毛，更划算
最近在看HTML5，杭州有研究这个的兄弟吗？求教	随便找个支付宝淘宝的前端呗
这才是特种猫啊！（转）	从博文见脖友渴望新生活，并且积极进取。
#小米手机随手拍#神车神标忍者神龟，大众大腕万事大吉	非常有感觉的照片，期待更多。
如果照片上的是你，你会说什么？	真壮观，可是没人分享，可惜可惜啊！
拒说好女朋友的标准。比男朋友轻50斤，你达到了吗？	那我女朋友是什么哈哈
小鸡炖蘑菇。鸡肉嫩滑，蘑菇汤浓鲜无比，好香啊	小鸡应该睡觉的，但它却被炖了。美味的菜。
什么是AEteam？那就是KTV也是中日英一起上！	你们居然跑去唱歌了！
如家今儿缘何大跌6%	如家有负面新闻曝出
求8年以上网络营销行业工作经验的营销好手合作。	求三年以上java开发工程师合作！私信留言均可！
人参，就要泡在杯具中，方显真滋味……	希望人参不要泡汤。
印度尼西亚巴厘岛现在什么天气温度？需要准备什么衣服？	男人棉袄，女人泳装！
你们愿意接受远方的祝福吗？	来自远方一条狗的祝福，这很有趣。
动态图：百变椅子。	哇哦！神奇的椅子能坐么会不会塌掉
北京春天，难得的蓝天白云，还有春风和花朵！	雷总的手机不重启吧？
成都！成都！久别的成都………稍后见……	团儿天天马不停蹄啊。注意休息。
我经常损你，是因为我相信我们的关系。	是说给我听让我平衡些的吗？
男女之间能用打一炮解决的关系千万别恋爱，省得劳神伤心。	劳神伤心的男女，能恋爱的千万别打一炮省得解决之间关系。
把现场的嘉宾唱哭了-----林宥嘉《突然好想你》alink	突然好想你，突然锋利的回忆，突然模糊的眼睛
凡客给你多10%的关爱alink	广告很不错，男主角很帅，哈哈哈哈
成功其实很简单，就是当你坚持不住的时候，再坚持一下。	费话…那是自我挑战极限，哪是什么成功！
不要吐槽了……_(:з」∠)_真的很受伤……	看看楼下这些排队的，你表矫情好伐。
Bootstrap中文文档中的CSS基础，n多亮点。alink	趁没封，赶紧先离线下载了。
我们不用学习考试，真同情大家	孩纸们，深深地同情你们啊！
那些所有你以为过不去的过去，都会过去。（郭斯特）	那些所有你以为过不去的过去，都会过去。
把脾气拿出来，那叫本能；把脾气压回去，才叫本事！	哥们既有本能有长本事了
金庸的十句顶不上古龙这一句alink	人在江湖，身不由己！
呼伦贝尔大草原的地标建筑：白塔	那边的云特别低，好像伸手就能拿到的感觉。
三年时间，八个产品，两件衣服#JonyIve#	jony和乔布斯一样都有自己的特殊服装呀
渔舟唱晚，不知乘月几人归。	轻风细雨弦丝袅碧波荡漾夕阳斜
混社会，就是要兄弟多。（转）	黑社会啊，大哥大啊，风紧扯呼
吃顿饭等69400分钟，海底捞，算你狠。	那火锅真有那么火啊。
男人和他的熊。这熊孩子一定以为自己是个人(Youtube精选)	在天朝这熊就要被抓去放熊胆了
煎两条至爱红衫，开饭！	哇，陈sir你煎得好靓哇
再练几个月我就不打算上班了。	革命尚未成功，同志仍需努力！
平胸穷三代，腰粗毁一生。脸大不是病，腿粗要人命。（转）	呀！反正就算活不下去了
加多宝好声音里的好爸爸，所有父亲，爸爸节快乐。	我们真的是太含蓄了，很难说出一句爸爸我爱你
给先帝来瓶酒，这一拜连天都蓝了，感恩大自然祥和！	在现代很少有蔡先生这样祭奠先帝的人了
这要是在莫斯科，估计得用AK-47	在北京有块板砖就行了
怎么聊才能给人留下好印象？要不要那么搞笑(via驴小毛Mo)	哈哈这是留好印象的必杀技么！
呃。我要的快乐是这么来的？	eros：回归本源的欲望
祝：朋友们节日快乐！和我一样劳动的朋友们有个好心情！	一直感觉长得有点像谢娜
招商银行二十五年庆。场面很大啊。	有钱就是好，任总偶求工作哈哈
人都哪里去了，几条大街都如此。其他城市呢？	发现秋裤塔。你王巍即将穿越秋裤
死亡，意味着不能再听莫扎特了。————爱因斯坦	第一次弹奏莫扎特时，听到的就是这句话，必须转起来
鱼呢！说好的鱼呢。我的鱼呢？「转」	每一只喵星人都会直立行走
墙上的大鱼让早餐很愉快。	眼神貌似在鄙视人类
射手们，果断转发踢走霉运！	最近真的很衰咧。
微博新版安卓客户端还不错。产品换人啦？	性能可，界面感觉一般般，内容越来越多，越来越乱。
来吧！请一句话证明你是搞过报纸的人	这些，这些，还有这些，稿子里面可不要写啊。
cos龟仙人还得搭配一个靓妞！	第一次看到Cos龟仙人阿。有意思有意思。
#果粉时刻#亲爱的读者朋友，你看到第几页了？	105。第十章，刚好是Jobs离开我们的日子
一元2粒牛肉丸菜头丝。	个银二粒？我来抢！
今天读完“邓小平时代“。很厚的一本书。	阅读是个好习惯，问您学习！
八卦一下。网易娱乐:传蒋雯丽出轨，恋小16岁男演员。	会不会是新剧的宣传软文、造势噱头？
如此迷恋这样的角度。VeraWang。女人此生的梦。	我家有高端定制的美衣美鞋喜欢的进我微博看看吧🎀🎀🎀👗
#伦敦奥运精彩时刻#""Hadouken！""""这位日本选手你犯规了""。	波、、、、、、波动拳？！
普通女盆友和二呼呼女盆友。（via：想念熊）	普通女盆友和二呼呼女盆友。（
曼联真正的灵魂在这里！谁敢不服，给我乖乖的躺下！	吾爵万岁万岁万万岁
清明再进空山，默立母亲坟前。很想问她好吗？欲说泪流无言。	今日走在十多年前送外婆的山路，一切历历在目，泪湿眼眶
一个内心强大的喵的自画像。	你觉得自己是谁？你就是是谁？内心要强大！
是你苍白了我的等待，讽刺了我的执着。	别等了，去找好吃的
总有一个人，一直住在心底，却消失在生活里。	他是我触摸不到的alink
常常陷入到刷了昨天的碗就懒得弄今天的饭的死循环中。	诶---你那是死命刷了多少碗啊
板蓝根！这要长成什么样的猪脑子才能说的出来？	事件营销做也不能拿这种事来做呀。无耻的板蓝根！
彩云之南，春节有木有想去的？	怀念大理丽江，如果有时间，还会再去一次。
KatyPerry蓝色妖姬。3月17日伦敦外出就餐后。	raisinghope里那个造型实在。
【图片：新一届上海市政府领导班子成员集体照】	感到一种团结的气象，好事
听说最近巴神很忙。（转）	和奥巴马的那张比较亮，哥俩还挺像的……
你能看出几部动漫的影子？能说出5个以上才是真正的动漫迷。「转」	那红色的一排应该是数码宝贝
能和这么有型的狗对戏，万般荣幸	他妒忌你和又青好了。哈哈
有多少人像我一样，是一年一度的向月葵？	1天的向月葵，355天的向日葵
做个小投票。大家会买新一代的iPad3么？。转发回复	华而不实。必须不要。
乡村版非主流，秒杀一切！	太帅气了，简直是真正的无与伦比
喜欢这样被婴儿的小手抓住手指的童鞋举手！	偶喜欢这样的小爪子。Muh
嗯。我想我已经知道答案了	还好不吸烟也不吸雪茄
下半年第74分钟，大连阿尔滨再入一球，3-0领先北京国安。	连球都停不好，国安你再思考一下吧！
人生唯一的敌人，是你的欲望。	人如果都没有欲望了，那活着是为什么呢？
加勒比海盗让他弹的太给力了！alink	Heisapirate！振奋人心的音乐啊。
搞了几天“四屏无云”，很爽……	老赵，你少了个不错机械键盘。
众粉们的身材哪位达到了这个标准？	这身材！俺一点也不羡慕！
我的老爸不是超人，但我很爱他。	喂喂喂要不要这么煽情！
小时候，童鞋们的睡姿是这样的吗？	我是睡得比较老实啦，哈哈哈哈
有时候，你越隐藏你对一个人的感觉，让你陷得越深。	因为明知不可得才更越容易陷入
“麻烦把刚才那个你叫出来下。”	羡慕你那样旅行摄影的生活
Ｂ血型的纠结个性，很准哟。	准啊、而且还会死不承认。
【阿斯顿马丁One-77】这款车全球限量发行77辆。这车太精致了啦	史上最贵。超过布加迪。可性能。额。
OK.\""个＂也不用。现在在澳洲已经太晚了。祝大家晚安。老陆	陆先生冒昧的问一句，您认识娄艺潇？
一张图告诉你“老板”和“领袖”的区别。	【促销与营销】一张图告诉你“老板”和“领袖”的区别！
拜托不要大白天，，，就跑出来等公交啦。	我的妈呀。吓一跳！
全球7打神秘组织，你觉得哪个最神秘？	毫无悬念地胜出！
❤好温馨，好有爱的一幕。#摄影#	硬系觉得D鬼仔BB特别玩得…
看似浪漫的画面，或许下一秒就有危险。	男的不放手，女的快溜走
腾出一只手，诠释父爱——温暖！	一代代传递，父爱如山。
人常犯的一个错，就是花费时间去在乎不怎么在乎你的人。「转」	那个男的骑的是那女的的车吧？
垂钓江湖侧，放马水云间。独处多清净，何必到人前。	虬枝入水，鱼嬉线丝，树翁端坐，只钓心情。
一个人的晚餐好一个清净，风景中的奢侈•••••	有点奢侈，一个人吃那么多
自我堕落时，看看人家！	应该是切过胃，刀疤依旧
台中，in秘密旅行。味蕾带我去了一趟希腊。	我现在很需要小白姜小红姜刺激我的味蕾啊！
成功的速度一定要超过父母老去的速度！	成功的速度一定要超过父母老去的速度！
难得这么齐全的照片。那些年，我们追过的明星。值得收藏！	世上也只有哥哥敢这样捏成龙了
明晨上演金木合月天象，夜空将现笑脸图样。（新华社）	但愿今天的心情也是
有些人就是意识不到他们的语言有多么伤人。	生动，形象(⊙o⊙)啊！
老娘四驱SUV，看谁拖谁！alink	给力的车，强悍的女人！
梅西抵达日本时显得很轻松。	必须轻松啊，刚刚在伯纳乌把皇马干掉，世俱杯，我们来了。
世界上最昂贵的16种物质（转原作者不明）	为了最后一页的亮点来的。可惜了
现在的身材还不错哦，，比较下，自信多了	你现在多少斤阿？挺漂亮的
空气污染指数:北京美使馆728(污染指数爆表).728！728！728！728！	国家为什么没有针对空前严重空气污染的具体对称？
据说原来的剧本是这样的。	唉，这年头正统中锋越来越少了
期待，是所有心痛的根源。	没有期待，就不会有心痛了吧……
【2012温网抽签】小德费德勒上半区，纳达尔和穆雷在下半区！	永远的同区。小德和费德勒太冤家了！
把这大叔P的霸气一点。跪求P哥。够霸气了吧	长刀短刀都是刀，黑道白道都是道！经典啊！
腰不能动了。谁有灵丹妙药？烤腰子什么的	好可怜，晓宇，fighting！
可能我只是你生命里的一个过客，但你不会遇见第二个我。	过客随风逝独自走天涯
冰消雪已融，阴霾天未晴，烟云仍乌蒙，京都醉中行。	飞雪迎春到，雪后晴偶现，阴霾空气在，京城待清尘。
午后狂吃吃完就睡难道梦中跑步真能减肥。	其实一看这体型就知道了那么胖不是你还能是谁
【致全体华润员工的一封信】	原来是这么一回事啊！这下子我明白了呢
【传说中的“夜西湖”】西湖的夜，温柔如水。图/网友缑墩儿	身不能致，心向往之
沉痛悼念同学邓英淘，他于今晨六点四十四分去世。	好人不长寿，祸害遗千年
今天下午CCTV-2市场分析室节目，16:50-17:13	是王世东主持的那个吗？
你向生活微笑，生活便送你一个春的笑靥！	热爱生活的人，自然生活也加倍地宠爱着她。
这是怎么了，iphone5上市了？！怎么又排上队了？	哈哈，来恭喜你在谢天谢地你来了中的精彩表现啊！
应广大魅友要求，放一个无水印版海报。PNG格式	磨砂很有质感，要是有实拍图就更好.
张之洞120年前建汉阳铁厂的奏折，他的亲笔字，写的怎么样？	字真好，写的好而且工整！
图片打开后，按Esc键看看是什么？别忘了告诉我噢。	l连按3次都是品尝我。！
【趣漫画】凛冬将至！图片来自imgur：alink	tony亮了，瞎掺和啥啊
#照片神标题#这才是peerreview啊！（转）	你摊上事儿，摊上大事儿了。
一句话不咯。高跟鞋扛桶装水的女汉子，霸气四溢(转)	其实你们不懂女汉子内心的苦啊没有男人只能自己扛
【北京61年来最强暴雨新闻汇总】alink	直到现在，我才意识到昨晚的雨有多恐怖。
大象和海豚的在母体中的胚胎照片	感觉它们都好安逸呀。
到了夏天，就特别恋这口的孩纸举爪。！（转	能不能拍一碗新鲜点的。
我们可以耐心等，幸福可以来的慢一些，只要它是真的。	此时的我一个人在寝室好想有场不计后果一个人的旅行。
那些年，我们一起用过的国民床单，这是当年的流行款啊！	我家现在还在用啊！
等到我们迷失了，我们才会开始了解自己。（BY梭罗）晚安，各位。	等我们觉得足够认识自己时，于是又开始迷失。
如果一定要老的话，那就老出味道来。——乔治·克鲁尼「转」	帅这个字已经不能涵盖了
水墨丹青，不忘初心。	不忘初心，方得始终。
情人节大礼，日本重口味AV女优！	发图不留种，你懂的。
太过分了，肿么能这么萌呢。	是高兴得瑟的还是嫌这柿子太硬苦逼的没法吃？
介个鱼缸太有创意了。	一板板啦，下次发个马桶鱼缸给你睇啦。
未来片BloodOfHeros之后，跟大卫林奇拍电视剧《双峰》。	我已经屯下来了话说跟大卫林奇这样一怪人拍片啥感觉呀
【吃遍香港】香港美食TOP50，没吃过不算到过香港哟。	这顺德除了龙须糖其他都有啦
第一次见一个人，体温在38.6°就叫一见钟情。——莎士比亚	不可能的那医生那么老！
CCTV最精英的频道何去何从？alink	你好，尊敬的石先生，能告是哪个吗？
特别惊险，集团ceo不是我。明天我告诉你们，是谁。	也不是我。明天能惊到你墨？
员工宿舍。都是钢结构。几天一栋。很漂亮。	这么大玻璃，节能么
西宁小吃，名字不雅，味道还不错。	其实就是一个饼子放不多的油哈哈
转发一个新二十四节气摄影，真美。	多么想回到从前，真美！
#U粉杂谈#填空题。妈妈，我想对你说：_____________.	我想你了，我爱您！
来说说你人生中第一次买的专辑是哪位艺人的？	谭咏麟--难舍难分，从此一发不可收拾，成为一辈子的伦迷
穿上3000年四条腿的牛仔裤，去哪都不怕没地方坐了。	把中间那条腿加长就行了，三足鼎立。
23.48卡拉fancydeeppinkishorange$100，480，000…谁送我我就嫁给谁！	特地数了一下是几位数。呵呵看看就好。
#趣图#我也想要这么一个马桶	男的大便时可以模仿开战斗机
你相信中国现在闹钱荒吗	粮荒是有人囤粮，钱荒是有人囤钱。我觉得是这样。
鼓浪屿的晚霞，颜色绚烂的惊人	去过那么多次，从来没见过
元宵爱情故事。咳咳……要抱着一种严肃的态度去看！	从此不吃花生馅了！摔！
摩托罗拉三防手机促销现场(图片来源：网友）	此人定看了72家租客，哈哈
我回到珠海。在建设银行某支行与南都记者签订了监管协议。	打多一个万字了应该是72412.20元，你打到72412.20万元了。
听说J.Crew最近很火？调查看看多少人喜欢她？	性价比高，不过到中国来就说不清了
明天团队郊外活动，求司机一名。！不用带车	有驾照、无驾龄的算司机么？
多亮这歌有点抡大刀砍棉花的感觉。	张伟不来那个咦咦看来干不过梁博啊
“风吹床单，正是寂寞的声音。”（BY安吉拉·卡特）晚安，各位。	我有我自己。所以不寂寞。晚安。小宇宙。
我坚信：关于救市，只要肯救，没有救不起来的……	作为满仓的我坚决赞成救市。
求学习，关于臭氧的清洁方式，有啥好处？什么牌子的臭氧机好？	不！要！在！家！里！放！臭！氧！这玩意我们清除还来不及呢。
绝望主妇每集结束语，没事可以读读！	从追SATC转到这部绝望主妇也是女人从姑娘到姑娘她妈的心路历程
喵喵不赏花，喵喵要闻花！	不知道为什么想起赵文卓了
到了东莞了，郁闷呀又热又潮的	原来昨晚输了-_-||这些回复有巴黑啊，巴黑长得丑，萨比扎扎扎！
周六周日希望所有烦人的人都別来烦人！	周六周日希望所有喜欢的人都来烦我！
开明专制也不是民主alink	现在不能谈民主，只有集中后才能民主
我回来了。在天津的国际排联教练员二级培训班讲课。	嗯嗯。好好提高下某些教练的素质！
我只能说这货的脸皮真厚！	对它来说，这是按摩球、不是仙人球。哈哈哈哈哈
#不懂就要问#PO主是什么意思？和博主、楼主的区别在哪里？	我第一反应是purchaseorder，又有数进账了
好演员一位位离去，剩下的只有明星了.	应该说下面该轮到明星了
太晚了就回家吧，如果心累了就放松一下再呼吸•••••••	如菓鈊累了僦放松一下再再再再呼吸…
北京排名前五十的餐厅，您去过几家？（转）	大错特错，不仅排名不对，还有好多好吃的店没看到，乱闹啥
【震撼人心！】妈妈能再温暖我们一次吗？	人们呐。请打开你蒙蔽的双鱼
哇哇哇，前面有台兰博基尼，好激动啊。	哇哇哇五菱才是王道
你们不理解的石毓智——我是如何学习的alink	点开了看也看不懂！
据说个高的女生，总会有那么一个瞬间，希望自己能矮点儿。	不不不，我的理想身高是175cm，我不要当170cm还是家里最矮的。
要学会用完美的眼光，欣赏每一个不完美的人。	每个不完美的人，有个把她看作完美的人。
这袜子，也是Lumia系列的？	这个配我的五指鞋，但我赤脚穿那鞋的
有没有赶脚我的贵族气质很适合演やまもといそろく呢？	有那么点木村拓哉的赶脚。
1984年的乔布斯和盖茨。一眼就区别出销售人员和技术宅了	哈哈，好玩，乔老爷，好帅啊
谁也别惹我！我有病！	哇咔咔，阳哥这是杂了？
【Lov图文】这系统设计得太人性化了！alink	从来都禁掉，一听到那声咔嚓就觉得浑身疙瘩
非常感谢你们！我会坚持下去，我们要拧成一股绳。战斗下去！	讲的好，一场一场打吧，加油！
【微博营销常见20种错误与解决方案】用微博你就用得着！（转）	这里面一堆错别字，小编真是太粗心了
今天是7月11日。《马后炮》8周年。	八年、小马变老马。
迎友人，喝小酒，畅快的午后。	贾导，为丧失了文化的山西做点什么吧！
人类已经阻止不了技术宅吃烧烤了！	我家有很多这种机箱，哇哈哈
吵架未必不令人怀念。	还愿意吵架就还有爱啊
如果你前面有阴影，那是因为背后有阳光。早安。	苦海无边，回头是岸
「完美的只是童话，不完美才叫生活。」	幻想是美好的，现实是残酷的
LadyGaga新香水大尺度广告出炉	尼玛，刚开始看成螃蟹了。
我最爱的绿色，适合所有季节的颜色/微笑	喜欢第三张图，明亮温柔又不张扬的绿
李代沫是一个银幕上标准的淫僧形象。	我特别那个什么agree，他给我的第一印象就是那啥。
最近很累。晚上都睡不好。	喝点安神汤……
完蛋，被互联网那点事转发了。	慕名而来，互联网那点事介绍的。
这才是真正的泳衣，旱鸭子们的至宝。	哈哈！不错！我现在急需要这么一件！
遇到这个坑爹的红灯，我想打人！每次在这里都不见两百元	我了个草我上次也差点！坑爹啊！
让你一生受益的三个小故事！（转）	舍得，舍得，有舍才有得！
复旦不是学习的地方【全文】alink	在复旦也就苦逼的研究僧在学习了吧
战斗四人组，生命不息，战斗不止。	忒有战斗力了，机车乜！新年快乐！
坐巴士，坐上层的福利：视野开阔。	多发点此时此刻的图片
其实，人生就是一场赌局！2560*1600	那家伙抽烟的时候，嘴不漏风吗？
#看图#“大师”王林在腾讯微博紧急声明。	真是服了！老底都给脱了，还用解释么？
一天的第一顿饭的第一道菜	这都什么点了才吃，先吃花生米就对了
2011年中国十大影响性诉讼alink	贺老师，您又回归微博啦？欢迎欢迎。
【老照片】孙夫人和未出嫁的妹妹宋美龄。	怎么长的一点都不像。alink
“loveq一代鞋”复刻板的样鞋做出来了……	觉得好似吾系几好睇
到魔都了…又开始倒计时恐惧症了…	去不了。啊啊啊啊妈了个谢特的啊
完全确认我鳖新型无人机无误！zt瘦驼	这就是央视7套啊。农业军事
哇，今天北京这个天气。跑马拉松的朋友要保重啊	哦那还真要注意，够冷的。
那些雷人地名……雷焦了，雷翻了。（转）	“上床”那张是隔壁11区日本的啊……
擦！相机摔到地上下了个坑😱	你跑哪去拍花了？个悲剧
英国BBC评出的人生50个必去圣地。有生之年，谁能全部走遍？	去了十一个，哦也。继续加油！
第四战——32分6篮板6抢断4助攻！韦德：是谁说我不行了？	thisismyhouse！06韦德回来了
放弃不是因为我输了而是因为我懂了	没有什么舍不得，只有值不值得。
大家都说金城武发福，众男星纷纷表示不服。(转)	一看到米帅我就难受--
美国河流鲤鱼泛滥成灾，一条条的往船上蹦。alink	到了美帝饿不死啊。都不用去担心没鱼吃。
——狗哥咱们啵一个吧！——矮油。猫妹，小心别摔倒	哈。狗哥眼疾手快啊！
BTW啊！爱某星座才会一直黑啊！你们见我黑过巨蟹吗真是的！	求你把水瓶给黑了吧
一组充满想象力的萌系卡通插画作品，来自俄罗斯画家Nataliya。	第二幅让我想起小时候从死了的母羊肚子里拿出的小羊
捕快哥正三观之作：“君子世无双”大家集体感受一下	第一张是怎么回事，我看到了后面有辆汽车！
今天中午的午饭，新疆拌面	杜老大，我们这些球迷都饿了
新闻联播出错片段alink网友吐槽→alink	昨天刚好真看了，当时以为是信号问题了
(2/2)尘入肺，有不要命者，还做早操。	这天，只能躲入防空洞。
营救同伴不成的胖达君，最后还砸了人家一下……	我看那熊专门弄死他…
长城上有些地方雪被风冲光了，有些地方很深。	活学教育通，成就你一生
各国手势的意思，收藏起来，以后出国旅游神马的可不要乱比划哦。	哪个2逼TM做的配色这谁看得见
一个人彻悟的程度，恰等于他所受痛苦的深度。——林语堂	这就是所谓的大彻大悟吗？
#今日面孔#据新华社英文报道：王-立-军被判处15年有期徒刑。	政治角力场的牺牲品
好吧，你们都是抢镜的高手！	最后一张，哈哈，海狸先森嘛？
没有你，良辰美景可与何人说。from《天使爱美丽》	今天电量终于100％了，这我就不焦虑了。
上帝啊，终于放暑假啦！	放个毛线，我的暑假只有补课补课再补课！
人的一生注定会遇到两个人，一个惊艳了时光，一个温柔了岁月。	惭愧！我一个也没遇到
我觉得，第一个遭到朝鲜核打击的国家将是中国。	很多年前就有这种担心；希望有生之年，这种事情不要发生
八十年代的北京大学。via画片集	那时候有那么白的肉色丝袜？或者是大白腿？
不要再卖弄风姿了！说的就是你！左一！	哎呀呀呀呀呀呀呀，好可爱
还有人在等半夜的球赛吗？	有，打算先打会小盹。2：30见。
我和我的小伙伴们都惊呆了！	这！不！科！学！。
想有七天的时间吃粽子嘛？阿狸这里有端午节放假攻略哦。	每次都让人家请假，哈哈
挤地铁1号线的女孩几们，安全起见，请先行服下避孕药。	昨天到北京，直到今天早晨坐一号线才觉得这里真的是北京。
钓那么多鱼干嘛捏？	都这么黑了，还用戴帽子吗？！
一幅感动了亿万人的漫画，感谢妈妈！	原来妈妈教的就是为了你以后可以好照顾她
陈寅恪的“恪”字，你发音成KE还是QUE？	00基本我听的几场报告会读以及我们老师都读que
我在民族文化宫恭候各位光临！	好！我就喜欢高大帅哥！
一位痛苦的父亲，在我家门上贴的纸！（IT坟墓）	不设wifi密码的邻居才是好邻居啊
在思考关于新版instagram，更适合发爱情片还是动作片？这是个问题	这二者有区别吗？！
【好东西】清洁厨房用品的10个绝妙招数。	用牙膏绝对是用盐好。不算价格了。牙膏你洗不干净你就喝薄荷水吧。
大大的陈年旧名片，你们感受一下	靠，我要得此神物放在风档前，也不会被差佬贴罚单了。
好吧，中国联通神补刀，微信被黑出翔了。	高级黑啊这是高级黑啊
一句话证明你看过《小时代》________alink	没有物质的爱情就是一盘沙！
茉莉花呀茉莉花，妈妈种的茉莉花，卡擦卡擦就没啦，bang。	这图明明是：哎呀小花你真好闻---让我咬一口---晕
上课玩微信摇一摇，摇到了班主任	上次查看附近的人看到了系指导员头像还那么风骚
你好怪蜀黍，我是小女孩！	你好怪蜀黍，我是小女孩
敬业的骗子。全家都被伺候了遍（转）	敬业的骗子'全家都给伺候了一遍。
【屌丝的24个特征你中了几枪？】alink	李宁361粉丝兼不喜欢拍照的平头路过
真正装逼的人是绝不屑于用“装逼”这种词的，必须用“装屄”。	那个字好多输入法都不支持，王总用的是哪个输入法？
很漂亮的小盆栽，也弄一排排！。	有时候幸福其实很简单
都说说，过年期间，你打算胖几斤？	我会不停的做饼干送人，自己靠劳动减肥
【每日一萌图】喵星人，矜持一点！图片来自imgur	hahahahahahahahahahahahaha
搜狐这期新闻专题设计的有创意啊。	雾雾雾雾北雾雾雾雾雾雾雾雾方雾雾雾雾
看到第一句，眼眶就湿了。	不咸不淡最好，真的，伪装无所谓
妇女节快乐。但，男士节是几月几号？	8月3号，等着放假发钱吧
一种很新奇的水果叫“哥伦比亚龙珠果”，有认识的不？「图转」	东北人称为：姑娘（niang三声念）
你不要走，太慢了，--给我滚！	别滚，给我滚滚滚滚滚滚滚滚滚滚滚滚滚。
杜普蕾、帕尔曼等五人的纪录片，难得啊。alink	上来就发现好东西。看来这假期是好开始。嘿嘿。
提问：天天聊的优势在哪儿？	天天聊聊每天聊整天
无事心不空，有事心不乱，大事心不畏，小事心不慢。	我空，乱，畏，慢全都有，你说咋办？
我不要只是生存，我要活得有意义。------《机器人总动员》	我不要只是生存，我想活得有意义
你有过这样穿衣的经历吗？你的长发还在吗？	哈哈，头发长的时候一直这么穿的
我叫俊介，现在我可是大明星哦！	这个，呃。铜铃般的大眼睛.
大家说说自己做过哪些板的板主吧。	novelshanxiwaterdistrict5digestdigestadmin
苏州，印象城试吃品尝，您有怎样的体会？	7月份的试吃预定都满了呀
如果你这些广告都看过，那么你真的老的可以了。alink	怀念小浣熊和柯达啊
从背影里看出绝对是个有故事的哥啊！	矮油，这都被你发现了
我多想跳，跳进你的河流。	我上岸了。是不是也该取消关注杜杜了
无论做什么，不努力，不坚持，再高的天分都无用。晚安。	这个夜晚美，不努力在高的天赋也没用。
经济像啤酒，没有泡沫不显繁荣，泡沫太多缺乏实质	那就得看倒啤酒的人的技术和心态了
二元一次方程都弱爆了。鸡兔同笼新算法。	现在才知道，原来我不懂数学···TOT
#无力吐槽#今天是除夕吗？不是！那你麻痹你庆祝啥？	信基督教的可以好好狂欢，不信的就洗洗睡吧。
这个很有意思，准备拍古灵精怪婚纱照的朋友们可以参考！	一生就一次，婚纱照一定特点鲜明，与众不同
这桌子碉堡了啊！绝对能够1V5啊！	这桌子现在有出售吗？
公务员考试常识40000题，有空看看，增加点知识面。	转吧。需要的看吧。
主人不要拦我。我要跟他拼了！	艾玛，这素啥品种？喜欢大的
图解资产管理行业的各职业生涯	这个实在是经典，建议置顶！
一个残疾人在走道上画的，刚画完，城管过来把他打跑了……	摆地摊的命，操中南海的心！
#315在行动#第一个目标是苹果。	研究了一晚上的八点二十可怜的苹果啊何润东其实是好样的
有其父必有其子，有其母必有其女。	我家咪咪生的没一个像它
英国BBC评出的人生50个必去圣地。有生之年，谁能全部走遍？	尼玛，塘山岭不算一个吗？
人类已经没法阻止印度电影了……（爆笑gif图）	哥、你拿枪指着人的动作好帅、
二十分钟内上减肥心得。	39分钟了，也许正在写长微博…等的估计都是胖子吧
所以到底是脆苹果党还是面苹果党？	我无所谓。脆的水多，甜，不过略硬。粉的口感还是可以的。
近年来，网络上的一些励志哥，哪一个会让你抓狂？（转	啊啊啊！看到最后一个我瞎彻底了！
一个素食主义者的午餐。	很健康哦，不过没有蛋白质呀，会不会胃亏肉？
胖纸唯一的好处就是人多的时候可以做副驾驶。（转）	所以很不安全所以还是减肥吧
圆珠笔下的小时代人物，看看你能认出几个！	是不是少了个简溪？
没什么比等待更难受，当你连自己在等什么都不知道的时候。	是，尤其怕等人！极无聊还焦急！
原来这是iPhone5没来的原因。(TechOrange)	我不想知道五袋苹果怎么来的，就是想知道它怎么没滴
【友·父亲】祝愿天下所有父亲健康、快乐！alink	祝愿天下所有父亲父亲节快乐！
诚实是我们不能逾越的底线！alink	对谁诚实？这是一个问！
FIFA11或WinningEleven2011？你会挑那一款？	首选WinningEleven2011！但FIFA11同样想要。
一场秋雨一场寒，吃胖点好过冬。	我是营养不良，没钱吃胖…
玩过的童鞋请转发。	哈哈每次一玩这个我就很紧张
有大量网友反映：装有qq电脑管家的电脑重新开机后无法上网。	肯定是Q和360两个都装引起的。我用Q管家就没事。
丝瓜烧毛豆，是极少数味道还和小时候一模一样的家常菜。	这两样竟然可以混搭
下周请关注苹果汇的有奖活动	亲爱的我要！shuffle！
小撒，大过年的，要和家属在一起	小撒，老章在喊你回家吃饺子呢。
连厉以宁的建言也删除，这国家一定病了！	病入膏盲了吧。删除它的，仅是可爱听话的小秘书
新浪娱乐6月20日07-12时要闻回顾alink	这种广告文字链功能不错比单纯一个链接好多了。
孙悟空神马的弱爆了。	应该是字幕错误或者口误吧
新的一年刚刚开始，12星座都在想神马，超准，吓我一跳！	嘿嘿！还是goodgoodstudy，daydayup！
不好意思，今天睡过头了，迟到了。	下雪啦下雪啦2012最后一场雪呵呵
教老外打麻将的教程。	==我突然觉得，扑克算什么里格毛毛
有一天，你回到家门口，看到这一幕，你会先干嘛？	晚上回家又得做噩梦
网编专用键盘……大家自取	计算机系学生的最爱
我随迈克·马伦将军参观中国人民解放军在浙江的基地。	假洋鬼子？混血儿？汉奸？还是合法间谍？
路虎用了奇瑞的发动机。元芳，你怎么看？	国人很多都不相信，可见。
忽然想起来，投毒，是贵大清国格格闺训呀。	祖国母亲，请记住！您还有一个女儿，叫朱令！
如果你还记得这部神作，说明你已经老了。「转」	晕，我不知道，也不记得，可是我还是老了
龙年到了！祝各位朋友龙年吉祥！心想事成！你我的快乐时代！	新年快乐，恭喜发财
居居居居居然下班了？狂喜！猛收！暴走！怒睡！	宝哥，听说你是个网管！而且专上夜班！
老了，讲课站三个小时，腰疼。	咋不给老师搬个椅子
日本最新创意红绿灯。！	好帅气，这样应该会大大的减少闯红灯的人
上了N年语文课的孩纸谁都伤不起。	尼玛这个我早就说过了。人家写的人还没想那么多啊…
那些年，那些个使人难忘而又充满辛酸的动人故事。	补上羊与狗的风筝原图
#午间分享#每一部大片的海报背后都有一个宿敌。	难怪“山寨”的英文翻译是“madeinchina”
那些年，未来遥远得没有形状，我们单纯得没有烦恼。	那些年，未来遥远得没有形状，我们单纯得没有烦恼。
看一次笑一次。现在男女交往路线图。	困了，看了笑了，精神了
翻到这张照片，想定做一件旗袍，不知道北京哪里比较好？	从回复来看，好火药的真人比她的发言更有吸引力
世界上有些离别，是真的离别。有些再见，是再也不见。	父亲走得那样突然，我们连告别都没有……
一张图告诉你为什么大陆剧找不到感觉。	イタズラなkissなぁ。ははははは
0805话题：你有没有动手制作或改装过什么东西，省钱且创意无限	vampireweekend！小飞你们每天都能给我带来点惊喜……
越小越要有情调，超强的36平单身公寓！	亲是攀枝花的？我有好多朋友都是攀枝花的！
上Gmail，上到我哭！世间最远的距离，不是生与死，而是404。	这是国家宏观调控！
测测你最假的一面是什么？超准！（转）#小智慧#	只有至交好友才会了解我的古怪与疯狂还挺准
哈哈哈，甄嬛传到底是有多红。	哈哈，看来甄嬛传真的是火爆了啊
原来陈冠希和汤唯都是今天生日。汤唯大一岁。	这一对也是天平座的！
永远别说「永远」，万物皆有改变。（你用英文翻译一下？）	Neversay""never""，everythinghaschanged
1849也许是我苦苦等待了6年的底部……	说到底，李大霄人品没有底
论“为什么范冰冰能成为国际天后而林心如不行”	我笑了#热门微博#alink
一想到明天要上班就没心情吃吃喝喝了。同感的转起	老板好多放我一天假，后天上班
总有个把蠢货是你不能抛弃的朋友。	嘻嘻，我是那个蠢货。我要努力聪明，然后不抛弃你。
现在终于能放下工作，拥抱我的好梦去。各位观众晚安！	现在的明星都不用iphone了
和Jacob吃饭顺便卖一下代言手表广告！	丹哥好像喝了很多酒啊，面红红。
我还是喜欢擦地，洗澡，洗衣服这样过一天。	神马是节奏：哟哟，哟，哟哟
给美国人当爸，为中国人做政协委员。	当官的有钱的都把子女送出去了，呵呵！
看一下你在中国属于哪个阶层	涨姿势了。有贵人帮我升两级吗？
没有旅行的生活，只能叫生存。	现在，我就喜欢生存。
离开北京的雾，来看台北的雨。≪痞子英雄≫台北宣传中…	啥时候回来看看青岛的雪？
盛典还给叶茂中这厮颁了个奖奖	恭喜叶爷啊····哈哈····
【科普】正确的搂抱猫咪方式。快来学习一下吧(转)	用错误的方式关爱了曾经的五只猫
都说婚姻是爱情的坟墓，更可悲的是，小三还要来盗墓……	哈，那就不要结婚。
这个面具色魔当年吓到了多少人？	我我我被吓吓死！超恐怖！
全球票房过亿电影（喜剧片）。无聊时一部一部看！（转）	全球票房过亿电影（喜剧片）
央视连线”前方记者王石”发回的最新情况alink	不是她淡定，而是那什么打多了，面部僵了！眼大无神非她莫属！
出发去辽宁，这里下雪了	据说辽宁雪最近嗷嗷大
弹开抢镜的妞。还是本娘娘最娇。（内容源自网络）	招淘宝兼职详情可私信。
你有拖延症吗？我暑假就想治拖延症，拖到现在也没开始治。	我该洗的瓶子堆得像一盘棋子。我决定，还是。先看一会围脖
当时我就震惊了！你想过用Facetime监视厨房炖汤进展吗？！	不小心太热了烧爆了我看你是多蛋疼==
#Lens夜话#你看完的第一本长篇小说是_____________________？	长袜子皮皮不算就绿野仙踪……
话说哥们也曾经瘦过……	除了头发，哪都没变。
#技术贴#超级实用的键盘快捷操作！开始练习吧！	太长了，还是鼠标吧
男人与女人起床对比图。看完后，有没有笑出牙龈。	还好，我是个懒女人
北京空气超150，室内跑步。	早上好'老子打针你跑步，还是你有健康的生活方式啊
月下桃花肥，想送那个谁。电话打半天，她却总不回。	您学鲁提辖，倒拔一树花.佳人无音讯，还得去出家.
iOS6上面的地图就是一个噩梦。	同感呀！非常大的噩梦！
传输我的数据、HERE地图、诺基亚音乐有更新。嗯，顺带测试尾巴。	尾巴被狗吃了啊！渣浪
在KTV开个包间。然后吃饭看球吹牛哈哈哈哈哈哈	为什么你没去解说呢？
据说是某中学楼梯。	就是重庆合川中学的楼梯哈哈哈
#看图猜电影#这是哪部电影？	调音师！超爱这部短片
不知道鸭子为什么总喜欢把头藏进水里我在:alink	在湖里面找吃的吧。
我在中8楼(中关村店)：带小小来吃虫子alink	给我们介绍下品种和口味吧
没有西瓜的夏天是不完整的！	西瓜是不能多吃的，要注意
“你帮帮我，你帮帮我，你是北京的大学者。""	给聂树斌平反，赔聂家1000万，高法官定罪服刑.法官是杀人犯.
我的那些不上微博的朋友们明显比我们要乐观啊	那是不现实的乐观主义
今天应邀和我老公一起来到央视二套《对话》栏目现场，很开心。	默多克太牛逼了，你真幸运。
我这个时间吃东西，应该算是下午茶还是午餐呢？	时间上算午餐，看品种是下午茶。
车队去了机场，准备好欢迎大大大老板来北京。	公司一半以上人去了国家大剧院，迎接这一季的发布会！
我很喜欢你，你跟那些漂亮的女孩不一样。	因为是可爱的男孩子
请用一句话证明你参加过高考：____________________。	不想种地就要考上大学！
妈，给我点钱！alink	omg，你长这样？我以为你只是个视频播放器。
人生就是一次无法重复的选择。——苏格拉底。早安。	missu。我忙昏了天冷，不要感冒喔
宫崎骏的手绘景稿，大师就是大师，超赞啊！	千与千寻，大爱宫崎骏！
掀开海浪，看看底下是什么？	。环境保护啊。童靴们。
人生有这样的朋友就值了。「转」	台湾大众银行的广告，梦骑士，非常动人⊙▽⊙
大家的早点都吃的什么？alink	姑姑手工做的包子。
第一眼看到它，你是什么表情？「转」	嘚瑟的小短腿，这是什么短片的GIF？没看过这么短腿的马儿阿
岁月是把杀猪刀！社会太残酷了。	的确是太恐怖了，希望我越来越漂亮
日久不一定生情，但必定见人心，时间会说出真话。	就是！有些人，认识她越久，就越不认识她。
舱门已关闭，等会儿大家水里见。	我的“苍”门怎么就关不了呢
狐狸就是狐狸，不知不觉就被它勾引到了。	这是狐狸？好可爱！
现实中，我们用真名说假话。网络中，我们用假名说真话。	不要怪罪社会太可怕，只是因为每个人都想靠装备来显得强大。
自娱自乐是一种生活态度。	图片很形象颇有感触.。
一本80年代政治改革的经验总结之作(转)alink	原来是香港出版，大陆禁止发行的
无限空间书架墙设计，还有多少书容不下。	打扫卫生的会发飙的
像孩子一样，真诚。像朝阳一样，温暖。	只能接受的是现实，可以改变的是人生。
敢不敢说出你的手机来电铃声？	NarutoMainThemem火影插曲
婴儿在父母中间的销魂睡姿，真相了有木有？！（转）#小趣味#	其实一般惨的都是妈妈
谁敢横刀立马，唯有地产大将军	而且是100%融资满仓，
带你走进樱花的国度。	带你走进樱花的国度
“复兴有三种：普通复兴，文艺复兴和中华民族的伟大复兴。”	，它用了2x的位子了。
每天进步一点点，每天退步一点点。一年以后你会发现差距是1260倍	没有坚持住学习，要反省下
不断的发现以前的自己是个傻逼，这就是人生。	现在依然傻逼，这可如何是好
这两天北京降温，感受到了寒风刺骨。	在猴子的花果山也感受到了，摄氏13度。
水上水下的差别！运动俱乐部广告。	一目了然，简单明了
一生的灵魂伴侣，就是那个你在他面前能做最真实的自己的人。	bethemost""you""thatyoucanpossiblybe
【心理学小故事】分享三个小故事，或许对你有所启发！「转」	是真的，这些人我不曾怀疑。
话说忒久没休假了。该去哪儿溜一圈涅？	whereeveryougo，thenumberofpeploeisthepoint.
微笑着容易过一天明天是未拆封的礼物	明天咱等着嵩哥的新歌《胡萝卜须》哈哈
新书封面（征求意见稿）	短线牛股，加仓跟进，精准买入！
#NBA酷图#这回钓的鱼真大！	拿霍华德当的鱼饵吧
年纪轻轻的，干什么不好，非要玩战争？	玩死自个儿，朝鲜老百姓就自由了
你就是你，世界上独一无二的你，从来没有人可以取代的你。	憧憬，永远在窗外，不怕你摆拍很美。
#微博名人#82版西游记，八戒和沙僧分不出来呀	妖怪怎么长得这么像人呢？
春困！今晚又推迟到十点播！	多晚也不错过看你主持的机会
你再不爱我我可报警了。	你喊啊喊破喉咙也没人来爱你的！
迅速流行，迅速厌倦——现在看到鸟叔和鸟叔模仿秀已生厌感。	哈哈，流行的久了，有的是经典有得让人心生厌恶
WWF公益广告：时光若能逆转，你会为它们做些什么？	但请先告诉我，我能做什么？
元旦前在普吉岛的朋友，有机会喝一杯哦。	打算春节去呢，看来要错身而过了
女生为什么要不停的买衣服呢？是酱紫的童鞋自觉转发。	这，这，这不就是在下吗？
最近老跟帅哥配戏。苦啊。	美女配帅哥那是应该的支持老乡。
看完此图就知道盐为啥这么紧俏了	奸商+无良zf+愚民=抢盐
所谓睡货，可用八个字概括：春困，夏乏，秋盹，冬眠。	每个人的身边都有一个睡货，你想到了谁？
新浪微博帐户突破4亿，但是我却感觉不到活跃。	小互。你有点矫情了
#祭#”春风再美也比不上你的笑”……安。	今天是邓丽君的纪念日？
献给一直在默默保护着孩子们的小熊。	和我的玩偶集团。猫咪，狗狗，等等。
这东西在你老家叫什么？	广东珠三角叫“马蒂”
别气馁，我们回圣城再战！	帮老板卖多滴票啦，斯大爷也不会翻毛枪。
没有受过伤的人才会讥笑别人身上的伤痕	没有受过伤的人才会讥笑别人身上的伤痕
你猜我会变怎样？答对有奖励哦！	口袋APP时刻装在口袋里
【星座配对概率表】低于60的不及格哦！(内容来源于网络)	我天蝎只和水瓶不及格
成熟的最大好处是：以前得不到的东西，现在不想要了。	Change。不想谈恋爱了。一个人挺好。
一个萌点笑点很怪的小漫画。「图via大象ROV」	噗==我就觉的形状怪怪的==
【五一假期怎么过】还没想好五一怎么过的朋友看此条微博评论。	天天看AV，我也会有审美疲劳。
史上最拉风的椅子。	这个是可以坐的，几年前报道过，貌似是台湾人发明的
赌一个杜蕾斯小铁盒的，你肯定没玩通过这个游戏。	魔界村啊，铁盒拿来。
人生的追求，要活得比以前好，不是活得比别人好。	你的旅途请让风景环绕
【每日一萌图】小企鹅走路，就是这个感觉……图片来自imgur	气候变暖，企鹅搬家开始！货车快来…
#推遍夜话#用三句话描述三体三部曲，你会选哪三句话？	哎哟，不错哦，这个吊。
转述中国官方说法：诺贝尔文学奖像个笑话。	鄙视你，立刻拉黑。
所有的好友都住在同一幢公寓里，这是我的梦想。（转）	看上去很美，不过这么做的肯定是SB。
巴楚恐怖事件令人发指alink	致敬，尊重每一个生命。
小丸子的包装，国内有就好了	什么时候才能有哦！
用一个地名证明，你在杭州生活过。我先来：卖鱼桥	白泽弄呵呵，老杭州才知道。
长款连衣裙让人想开始一场悠闲的约会！alink	好喜欢左上的裙子呀
中华民国总统府网站：alink（免翻墙）。	看看总统的每日行程
易中天真身出没，谁与争锋	易中天老师真身出没，大张伟还不赶紧退下
《回忆我的几个极品外教》	臭脚为什么有市场？因为有人捧啊！
这样穿衣服，你学不会的……	这样穿衣服，你学不会的……
疯狂电视台。明天又加演四天六场，大家辛苦开心的彩排啊。	赵哥，你说你大学毕业后是不是也该考虑找个伴了啊
为什么我觉得蚊子是一种特别SB的生物	哈哈，就是就是，傻傻的
我打完篮球，就看电视转播CBA。你看吗？	在北大人民医院呆着呢…来北京看病了…都一个星期没电视看了…
我家的巧克力你们稀饭吗？	我的狗狗也叫巧克力。是腊肠
中国的俗人太多了。一个配得上我的都没有……	同意！舟舟这回证据牵强
忽然想念呼和浩特老绥远烧麦。	还有焙子。很好吃。
公司安静了，自己写字玩吧。	不错。不会写毛笔字的飘过
我有一个很棒的妈妈，我爱她。	ilovemymomsooooooomuch
【娱乐一下】后悔药，每人限购一瓶，想要的转走。	至于副作用嘛，请参考《蝴蝶效应》
咱也该换辆四轮的？我在:alink	目测是14新款大切。
时光如水，总是无言。若你安好，便是晴天。	你若安好、便是晴天
在平常的照片也可以变成一幅有创意的作品。【JohnThörnqvist·图】	创作出来的图片怎么都是没睡醒的灰蒙蒙
好兄弟就是老了也还要一起打游戏！「转」	好姐妹就是老了也要一起去逛街
快来看趴趴熊。这货怎么可以懒成这样啊！「转」	我家的猫也是这样的，经常睡得四脚朝天。
一语道破天机啊！确实，读书不多，想的太多！（转）	谨遵教诲，我记住这句话了。谢！
这个点钟有点饿了，来个草莓布丁吧。	吃屎啊！还不睡觉！企鹅！
李克强：靠刺激政策、政府直接投资实现今年目标空间已不大.	想不出，不靠疯狂印钱以外还能有什么
据说，你流出来的眼泪，是你脑子里进的水。	哈哈，好多年都没哭了
各位博友、朋友、同事：恭祝各位2013新年好！巴松狼王敬贺	2013的第一个祝福送给狼王！新年快乐！
我总是在安静的时候想得很多，然后难受很久。	我们总是在安静的时候想得很多，然后难受很久。
#早安微话题#酒后吐真言，你酒后说过的真心话是？	我喜欢你，祝你幸福，好煞笔
最烦嚣张浊世，且渡简净一生。心中花开花落，不愿与人纷争。	喜欢！心中花开花落，不愿与人纷争。
成熟的最大好处是：以前得不到的东西，现在就不想要了。	现在珍惜的，以后也会不想要了对吗！
我想不管这个世界如何变化，人们还是愿意相信美好。	嗯嗯，愿意相信美好
#日系写真#已为人父的瑛太。	到目前为止看着最有FEEL最欣赏的日本男优！瑛太！Lastfriend！
这才叫镇定。注意看雨刷。	会不会腿被夹住了，否则难以置信啊
未曾尽力之前，不要轻易求助于他人。晚安。	尽了全力事情还没有成功那也就代表结束了，再求助于他人何用？
可贵的情谊，并不只局限在人类之间！	有时候，动物的情感比人来的更真切更丰富。
【坐地日行八万里/巡天遥看一千河】竹心草之荐之alink	诚谢好友国网美馆之转赏！
【趣漫画】人生最悲伤的事，莫过于……图片来自imgur	不经历风雨，怎能见彩虹。
网易门户事业部加薪内部通知邮件。	那其他门户或者大型网站是不是也该跟风啊。墙裂要求跟风。
摇摆的床，躺在上面是何等惬意。	这东西睡着那叫一个恶心
有一种爱，只是在你背后默默为你撑起一把伞。	还有一种爱，淋着雨一起在穿行在人流中。
90后会做饭的，请举手！	soeasy。别老小瞧90后好吧
【科普帖】4分钟，让你了解无线网骗术。alink	不知道国内会不会有。
救命！谁来收了这位翻译大神。「转」	虽然是后期p的但我还是笑了。
一张图告诉你为毛央视315要黑苹果。	央视吃多了就变色了！
从此——你的世界再无“困难”二字！（转）	嗯！无困难，但，缺钱算困难不
最好的地方，是没去过的地方，最好的时光，是回不来的时光。	最好的是青春，是失去了的青春！
中国篮球，你有对待基德的耐心吗？alink	匹克给了你多少，一天到晚就蜜基德。
当年相知未回首，空叹年华似水流。	摇得时光悠悠过，荡走岁月苦与愁.借问船家欲何往，艄公曲唤山河秀.
“我的体重是我自己的事。”“球状也是身材！”——《加菲猫》	严重赞同.球状麻是身材撒.``
有这样的男朋友就嫁了吧。99朵烟熏三文鱼打造的玫瑰花束	说好的芥末巧克力呢
“生活的压力和生命的尊严，哪一个重要？”	郑智化歌词呗？“生存和面子问题哪个重要”
一张很现实的图，如果你认为对就转发下！（图片来自网络）	真心别放这种图让人桑心
瞧瞧，中华民国行政区域及领土纠纷。	好好的一片桑叶，变成了一只鸡
新年快乐，来领龙年祝福啊！	新年快乐啦。同祝哈哈
【100万人民币在世界各地能买到啥样的房子】	你应该放张广州的。
小道消息：某知名电商公司开始裁员，300-500人左右。	大嘴Fenng又有八卦了。
龙年将至。祝大家万事如意。	借老板吉言，大家龙年吉祥。
想不开，就不想；得不到，就不要；难为自己，何必呢？	不要刻意，顺其自然。为难自己，是痛苦的源泉。
【调整后的新浪组织架构】大图：alink	新浪组织架构，腾讯科技制表？在搞竞品分析？
祝前线及后方所有符合条件的女战士3.8节快乐！	安久粑粑辛苦了！加油
＂把生命的每一天当作最后一天来过，保持对生命的敏感。＂早安	是啊！如果能这样，那即使末日真的来临，我们也能坦然面对！
快看，对面那货没穿衣糊！	哟那两只看得可真入迷呀
方大同做客，大家有什么问题可以发过来！	北京演唱会有请嘉宾吗？愿不愿意请张靓颖作嘉宾？
朋友们早上好，今天空气质量。	大老，你太早了。老人家不宜起太早！
总有一张图片，会触动你的内心。	有时候人还不如畜生
喜欢寿司的童鞋请自觉举手！。	这诱惑，，无法抵御
大家好，我们是“杀猪刀联盟”！我们的口号是：代表时间消灭你。	我不要说我的莱昂纳多啊，哈哈哈
芙蓉姐姐：看来真得学游泳了！	芙蓉姐姐今天很可爱。
【禅意】一花一世界，一叶一菩提，一砂一极乐，一笑一尘缘。	【禅意】一花一世界，一叶一菩提，一砂一极乐，一笑一尘缘。
李敖老师敦南金兰书房一隅。	要是有这样的书房我也一周六天不回家！
我这种壮汉，一穿细高跟鞋，就好像在欺凌强暴它。	第一次总有点不舒服，习惯了就嗨皮啦！
中国速度：30层酒店，15天的变化。	光鲜的速度，豆腐渣的工程太多了
站在爱情顶端的女王大人。	哈哈哈哈哈哈哈。做了三年纪律委员没做过波😏😏
你有睡觉的时候不敢把手伸出的“床边强迫症”么？	会麻掉当然有强迫症啦
“来，给爷笑一个！”“好哒！”	哈哈，来，给爷笑一个！你不笑？爷给你笑一个！
盘点令人发指的十大神镜。	真玩家只看参数不看价格不求最好但求最贵
60分万岁万岁万万岁！#丁一晨每日一画#	哈哈哈笑死我了不得不转阿
#越夜越JD#你觉得最容易网购成瘾的星座是________？	巨蟹座。因为巨蟹座最居家了，，连门都不爱出。只能网购
其实，斗力，斗智慧，斗胸怀，我们都能赢。	中国人最牛啦，谁也别想跟我们斗，有谁比我们狠
来银行办事，坐下后，听旁边大婶说：＂你好，我死期到了＂。	抄袭别人的段子已成习惯了，哥
我像一只小虫，在夕阳里蠕动。	动比不动好放平心态
如果路口红灯改造成这样，还有人敢闯不？	前面的车刚过了一半红灯亮起来了怎么办。
TomCruise（汤姆·克鲁斯）——1985年的《黑魔王》	不解释把你女儿嫁我
其实呢，我都有点不好意思出门，大伙都说我太帅了！。	的确····太拉轰！。
在我们心里，你已经砍下了三双	KD威武！韦少无可替代！
捡肥皂。有木有感受到世界满满的恶意（转）	猛力一插！fuck！哇。爽。
甭管烤得怎么样，反正每次看到面包出炉，我都挺开心的	能不能在微博上给我们分享几个方子
把数码产品带上床会让你失眠！	每天在床上玩手机玩到累，一闭眼就睡着了
纽约广告节金奖——聆听音乐，感受生活！alink	至到最后才知道是什么意思，音乐很不错
重庆，热得够劲！顶着38度高温去吃火锅定很酷！	什么时候能参加一下你的影迷会.
闷雷阵阵，闪电频频。如果这是摩斯电码，老天爷，你想说什么？	啥也不说了，越来越like你了
快讯：诺基亚西门子宣布裁员17000人，作为全球重组计划的一部分。	西门子？和诺记的合资公司？
放在你收藏夹里很久一直都不舍得删的网址是____？	没错，IE的收藏夹的确很烂！
长沙。除了下雨、会做电视外，你还会神马？	再过一两个月会热死你
【可以带着功利心修行吗】alink	心有多大，功德就能容多少，无限大，便能容无量功德
古城说旧梦，荒地刈新草。云起在天际，平然却静好。	那时年龄不大，农忙都是帮忙，好恐怖啊！。
选一种姿态，让自己活得无可替代。早安大家。	赶紧下场雨吧！我快中暑了。
#315晚会#央视315晚会国美接下来也将出场	哎，生活怎么美呢？
校内上看到个某大学的孩子为防舍友投毒………	话说，金鱼拉便便了怎么办？喝了？
刚反覆的看已剪好的MV发现了一个问题。	老大说话果然一直文人气质十足----朦胧啊！
以前这个diao说出来会脏了嘴，现在很多人嘴里随便diao了。	偶全部中枪(⊙o⊙)哇
一个人也要好好吃早餐，对不对！	热爱旅游户外，阳光的本职热爱生活，关注快乐就关注我吧
这俩倒霉孩子。肯定是失散多年的亲生兄妹吧？	魂淡！玩儿死人家了！
#DC搜索杨佳琪#<搜索>首映丹磁收合照了。	这个。似乎有点理解—粉丝大多是女孩子
连战访大陆送礼习近平：油画与有机食品。这个有么斯深意呢？	台海关系是有话好说，有机会！
我不要只是生存，我要活得有意义。——《机器人总动员》	可是我现在生存都成问题
你不会知道那个对你突然发火的人，忍了你多少次。「via腰好哥」	就是，太想告诉某人了！
刷了一圈，没一条正能量。	正能量是什么？能吃吗？
普通草泥马VS文艺草泥马VS二逼草泥马。	多逗趣的萌宠啊……
赶飞机，天还很黑，突然让人想起小时候起大早去看升旗。	升国旗多让人精神振奋
吐槽我亲爱的清华【全文】alink	童鞋你吐槽的不仅是清华，至少我的学校也是这样。
也当一回徽州女银。	要再换套衣服梳个髻啊。
还要淋雨回家的宁波观众朋友，谢谢大家今天的热情！	我擦，是今天啊。我一直以为明天。
活得快乐，就是最好的报复。━━━王尔德	原来真理是如此简单。
放我下车。快放我下车。我不要成为奇迹。	欢迎乘坐15路车、
平日萨内蒂，雨中因扎吉。大场进2球，一路笑嘻嘻	没操纵你的韩寒一起玩？
小猫玩猜球球！萌死你啊！alink	这猫难道是刘谦养的？哈哈哈！
打扰本喵爷睡下午觉的一律吃拳头	伸手敏捷、。！出手似闪电雷鸣般犀利有木有啊！
成功的速度一定要超过父母老去的速度。努力吧！	压力顿时大了许多……
交一个朋友，需要千言万语；和一个朋友断交，只需要三言两语。	不懂得珍惜朋友的人可能不要半句话就能断交。
'小外甥女'发条微博纪念这个因为你的到来而变得可爱无比的日子	天天陪你的图，你也不回复下。
天气热就这一瓶可透心凉了，真过瘾吖	呱噻。台湾的呱酒耶！一定很好呱！
我希望我可以强大起来，可以保护那些我在乎的人。	哇哇哇！好口爱的PP！
一个不幸的消息，Google要关掉GoogleReader。	GoogleReaderwillnotbeavailableafterJuly1，2013！
#一句话暴露年龄#你小学时候最火的动画片是什么？晚安！	还有多少人记得《希瑞》……
京东十年庆3D生日蛋糕精彩制作过程放送啦！alink	确实不错的创意啊，祝福京东
有的时候站在低处往上看和站在高处往下看，看到的景象也差不多	飞哥又跑路了？！羡慕。
有洁癖、有生活态度、有原则的喵！	哈哈，这让我想起一个人来…
喜欢家家户户在阳台上欣赏日落的感觉alink	如今的日落总是伴随着烟雾缭绕，但不是炊烟，是PM2.5！
有件事我纠结到了今天，你是否也有同感？	这应该是个商机啊，兼容插头
这个蒙古汉子唱的不是《那些年》，而是《2002年的第一场雪》。	侯磊的妈妈像不像去年金池的妈妈？
不要羡慕你没有的，却忽略你拥有的。早安。	也是不要贪心，拥有幸福靠自己，早安，美兰姐！
最适合南佳也和惠比寿麝香葡萄的是：董永与七仙女。	服了，大，这也能yy两小时。
泰国水灾中的人民智慧。最后一张亮瞎了！	最后一张是传说中的美人鱼吗不过长得也太丑了吧
#同花顺#忆前公司两三事（同花顺）alink	这样员工都走了，同花顺完蛋了！
将要飞出雪的世界。大深山中居然密密麻麻的散布着大量的村庄。	飞着还可以发微博么？
<私たちはそれを水で游ぶ>（翻译：偶们一起来玩水吧。）	这个表情被秒杀了。
要是开放去钓鱼岛的旅行，钓鱼岛早就收回来了。	尽早开放吧，让他们瞧瞧俺们中国人的气势！
关于“微信收费”的常识alink	这篇比奥卡姆剃刀那篇写的好太多了。
受不了啊，你要什么我都给。	我也是。你要什么我都给你！
你想和谁一起在这里一起喝杯咖啡、坐着聊聊天。	坐在里面感觉鼻子好过敏
一生经过彷徨的挣扎，自信可改变未来#晚安，韦德#	G7，拿下。信你，D.Wade
我现在特别想知道王局从美领馆出来，说的是哪八个字。	萝徳鲍卜就爱祁书。
如何借助”错位“拍出有趣的照片。\(≧▽≦)/。「转」	越来越多的人玩起了镜头，
喜欢这感觉，床幔也很好看。	黄&蓝很惊艳啊北极熊是亮点
大热天肿么能木有冰激凌呢	小搜，你吃冰激凌的样纸真憨厚
魂旦。乃都不了解小王纸的心意嘛！	这个蛋疼菊紧的东西····
生活就要像疯子一样的过，才能忘记生命给我们的颠簸。（转）	那俺就努力做一名疯一样的女子。
好声音？还是“好呻吟”？	淡看啦凡事哪有那么多标准
这是国土安全第三季在波士顿首映啊。	两个人犯罪嫌疑人，都是犯罪高手啊，极强的抵抗和心理素质啊！
凡事全力以赴，就能快速倍增财富！	WOW，陈老师太棒了！感谢陈老师！
一花一世界，一叶一追寻。一曲一场叹，一生为一人。	纠缠来去其实都为那一人。
认为将来你女儿会是美女的请转走。	我也想有个漂亮女儿
Findthemagicinyourlife.寻找你生命中的奇迹。	Findthemagicinyourlife
香港宽带，199港元1000M带宽。大陆网民崩溃！	这。！能在那儿买了回来用嘛？！求可以！敢不敢！
妹子们，乃们期待炮哥向乃们发出炮约么？理由是？	字太丑，无法当文艺青年以才服逼，只好以屌。
博尔赫斯：“我一直认为，天堂就是图书馆的样子”早安	早安有缘！享受天堂。
纹身前后注意事项，转给想纹身的亲们！	收藏，等要纹的时候看看
38节在天河看中超，撑恒大！5：1大胜！	原来你都系度。我系主席台上面。哈哈
AS罗马：村长被踏实弟扛走了。	擦，这是准备入洞房么
咦，一觉醒来变成蓝V啦。，大家说这是肿么了#微博桌面#	不得不说，蓝色很难看。
据说屌丝的短信箱是这样子的，还有更惨的么？（图转）	额……怎么可能！不过我也是
有关养狗常识的十三个问答。	喜欢养狗狗的，值得一看！
连飞了几个城市，终于可以回家了。	刚到北京天气很好。舒适。
明天好好开会，偷懒要你好看。	明天又是一个好的开始
这是一个悲伤的故事。「转」	出口韩国美衣大厂生产全部实物拍摄质量保证白菜价！
原来古墓派在瑞典…我很期待在那里会遇见谁…（蛋花儿网）	没装地暖，我就不去了
梁朝伟和章子怡要来了，楼下物业工作人员正在安排专梯！	章子怡不跟撒贝宁一起去吗？
爱像水墨青花，何惧刹那芳华。	好美，好雅，好喜欢！
献给元旦即将加班的苦逼的程序员们。	啧啧好冷。估计这警察叔叔的老婆也是程序员吧
诚实的农民伯伯。——央视新闻	如果不是断章取义的话，这人心咋这样啊
刚回北京就被热昏了！咋这么热呀！骄阳似火啊！	废话，也不看什么时候了
喵星人你看见啥了！(´・ω・｀)（转）	猫瞳完全张开好萌啊
镶了300000颗水晶的奔驰SL600	走路小心点，赔不起
真的牛人，可以把书堆成这样！	还以为是《星球大战》里没完成的死星呢
【招商银行一个让所有已婚男士潸然泪下的功能】(图片转自网络)	广发行网银也有跨行归集功能！
高帅富VS屌丝的手机，最后屌爆了！	好吧高富帅果然就是不一样
1970年广州秋季交易会菜单，奶皮猪油包，3毛一份	灌汤饺0.3更震撼，现在都没人做了
向大家请教，腰扭（较严重）如何是好？谢谢	去长虹桥国医堂找崔述生大夫，超厉害！
缅甸今起放开私人办报。等到我能自己办报那天，还有报纸吗？	哈哈，。把罗字也加上吧。
在前往克神克腾的路上，凝望这沉默的远方。	是来内蒙了么。赤峰市的克什克腾旗。
太多时候我们都是一个人.	嗯，这是最好的年纪也是最坏的年纪。晚安
来来来，哥来帮你挪开！喵星人	成精了已经，太恐怖了
奇幻世界里你看到甚么？	看到的是一堆布条，好像陷阱
鲍勃也开始喜欢上中国茶啦	哇，老外也爱喝功夫茶了。
这插座真是业界的良心啊！「转」	业界良心啊，充电器插头和三头插都矫情得要死谁也容不下谁
女孩们，一定要让自己拥有被爱的条件。	社会就是如此现实，。
ValderFieldsalink你可能在找这首歌！	这歌，我已经听了6、7年了。他的其它也很不错
［这里是联合国］联合国每天都在努力应对全球挑战！	辛苦了有你们世界才不会乱
很多70后、85前都会怀念那个时代。#李若彤复出#	年龄不是问题的，复出挺好的
从今以后，咱就是已婚人士啦。哈哈哈	恭祝新婚燕尔，白头偕老！（新娘那叫一个漂亮，兄弟你赚了）
据说这个动作能1分钟做超过30次的证明你大脑特别灵活。	额。这样啊。试一下哈。
【如此“民主”】——帕维·康斯坦丁（罗马尼亚）画	如此“民主”，你我都心知肚明
多久没打野球了。晒死我吧。	西安今天37度捏。北京比得过么
🎤唱吧！你还我妻子！😭😭😭	嫁你多好连麦克风都有
这个做墙纸怎么样？我自己拍的，哈哈。	用最近做手机大牛的话叫土包子
生命中最大的课题——坚强。	坚强并快乐的活着。
身为一只虎，总部设在阳谷县（Sunnyvale），雅虎的命运可想而知。	这个太有趣了，但是哪个是武松呢？
开始很感动，结局很悲伤！	看不懂，我智商太低了
主唱有回应呐！就在评论下面，可是为什么转不出来，就截图QAQ	为什么到头来还是你站出来
恭贺区越山大师八十大寿！	我可以打110报警噪音污染么？
三位获得年度最佳商业作者的是，金错刀，张小平，王福重。	怎么没有吴老师啊？
我想给自己一个牛逼的机会，趁自己还年轻。	我想给自己一个牛逼的机会，虽然正在老去
工资2000的人看2遍，5000的看5遍，1W以上的请背下它。	只看了一遍的默默转发
1946年的帝都罕见彩色照片123枚alink	我的北京城啊，我的故乡，早已不存当日的风采
姓【操】这个姓的先生杯具了！	名很久的话就恨霸气啊
小潘的早餐，真能吃。多年后又来我们食堂吃饭了。	任总也不给点好的吃。小潘晨练饿了。
胖子无论因什么而哭，都有一种喜感。	胖子笑也好玩，总之，胖子可爱。
【祝福航天员】上下顺利，天地平安！	高高兴兴上班，平平安安回家
求教帖：“事“字查字典部首怎么查？这部字典没查拼音。	没部首的用第一笔！
一周又一周。无尽的循环。	接下来的这个星期要连上七天呀哎呀
正驾驶，你TM的别单手扶把，我给你看地图，你TM的好好开。	你玩的东西还真多！
感冒多发季节必备神器啊！	多弱智的日本人才能想出这玩意？
于大宝制造点球，王永珀主罚命中，全程动态图送上！	我激动了，虽然是点球
我最好的戏是在7岁那年。（转）	星爷，一个闷骚男的真情！
追姑娘从不是件有意思的事情	这个说得也太绝对了吧。似乎爱情就仅仅是那一眼冲动。
没有买卖，就没有杀戮。	坚决不用象牙制品。
接近3年的感情，呵呵。异地你们懂么。【转帖】alink	这是你失恋了？alink
不给《云图》任何奖项的奥斯卡是一届耻辱的奥斯卡！	貌似……云图要算入2014年的奥斯卡颁奖才对吧……
四两拨千片牛！千片刹车片？	我也不相信作家会写“四两拨千片”，不过，字还是抄的不错的
Jack其实真的能活下来的。	Jack要是早点儿看到这个就好了
真有人叫这个名字啊！无论卡片正面和背面都是精彩，笑抽了！	这小子肯定一出生就得罪他老爹老娘了。
不是我们减不了肥，而是敌人太过强大。#美食#	你放开我放开我，我要减肥，你再强大也木有用！
如果说学javascript就像学数学，那么学html/css则如同学语文。	呵呵，这世界不就是一分为二吗老兄
7斤8两小胖妞，前几天还坑爹，现在可是一个天使宝宝！	恭喜从坑爹变成了爹！
淡定的大叔，这是啥牌子电动车啊？	我地去，怎么不漏电啊？
我想知道有多少人是刚起的。评论里报个道吧。！	已经上了快三个小时的班了
受不了啦！集体卖萌啊。	太可爱了。求抱。回家。么么
屁股太大的悲哀。（转）	我很好奇它是怎么爬上去的
粉丝：人耽溺于微博的致幻剂。	微博，人耽溺于理想和现实冲突纠葛的温床
给十年前的自己发条四字短信，你会说什么？	第五张，干点坏事和第九张，珍惜青春。
老公出差，看到家里的留言，我哭了……	呜呜。好好哦。这样的老公哪里找哦`
据说当你看出亮点时，你就会震惊的！	诶呀大白天的肿么可以这样，
祝贺我国航母平台试航成功！中国该走出去了！	捡人家的垃圾来充大头，真是悲哀…
准备和三个姐姐上场啦，最好的未来…	小葡萄好萌姐姐亲一个Mua。
矮油，好像下班了……艾玛，好像放假了……	总算是有假期了〜暴笑三声！
我也不理解李庄当时为什么要认罪alink	我是不理解007在酷刑下，为什么总不认罪！
好雪。今晚可热壶酒，闭门读禁书。	并红袖添香，美人在怀
一串串表情丰富的葡萄，太有才了。	都舍不得吃了，值得收藏啊
永恒玫瑰，定格在爱的永恒之间。	永远定格在永恒之间。
小主淫，不吃的不要浪费哦！	诚信互粉！互粉必加！
钥匙插进去以后动起来原来是这样的效果喔……「转」	这感觉好有艺术感啊
分享图片:试验了一下手机照相效果，在东北，大家评价一下效果？	不离本行--轴对称！
【老照片】你是否也想给自己拍上一张这样的照片？	中国黄金年代的feel。真的不一样。
【12星座男缺点一览表】真他娘的准啊！【全文】alink	巨蟹男准爆了好吗！吃着碗里看着锅里闷骚！
国梁大校，离将军不远了。	奥运会一完，大校还要多，不信等着看
休息时，可以聚焦！拍的还行吗	和我走失的儿子一样的，
解释永远都是多余，理解你的人不需要，不理解你的人没必要。	喜欢推理的朋友可以关注我
有人感激过你的善良吗，貌似他们只会得寸进尺。	有人感激过你的善良吗？！
这是真的假的？我都慌了！	当时我看这部剧的时候就觉得，你是缩小版的，O(∩_∩)O哈哈。
全球移动互联网大会开始啦！	转让本人的小米2手机，有意者私聊！QQ：263996097
旁边那个二货我不认识它。（图转）	旁边那个二货我好喜欢他
BB满月是30天还是31天？	满月是按照农历算的。
你们的妈妈也会把你们的卧室叫做‘狗窝’吗？	你妈妈的意思是说你是狗吗
八字桥，这才是真正的江南style。晚安，绍兴。	据说这是中国最早的立交桥
我们的传奇星越来越茁壮了⋯谢谢大家的支持！alink	在那里啊？好惬意的感觉
怎么看也不像失恋33天啊，看这个笑容像恋爱33天	这个类菊花造型，加上下面那个给力“进攻”，基情4射啊。
刚才摘录并支持胡在十八大讲话内容的贴果然被平碧了么……	丫，电脑中毒了，自动转发。
要不是看在你妈养我的份上，我早挠你了！	这视频还没完呢，最后宝宝还把尾巴拿给猫咪吃。
上周第一批笔试结束被铺天盖地的试卷包围了。	这妞看上去还没成年
在最近访问四川省期间，骆大使也非常赞赏该省的自然风光。	乡下亲戚见此照：”这个是哪个大学校的教授哇？“。嘿嘿。
为什么以前排队的银行现在人这么少？什么迹象？	店多了，用网银多了，你运气好碰到少的时候，经济确实也差了。
#现场##云南地震#从山上汹涌而下的洪流。我们在洛泽河镇。	为什么没有人来关心这些？
【坐地铁碰到一个内裤穿在脑壳上的人】惊艳！alink	转发；爹娘；没选好时间，造了这么个疯子。
猫仔，你也大闹天宫了吗？	会缩骨功的喵星人。
6·29反劫机机组累计受奖已经超过2000万元人民币	我担心下次别的机组为了奖励很冲动
一种很新奇的水果叫“哥伦比亚龙珠果”，有认识的不？「图转」	作为半个东北人，负责任地说，这是姑鸟
#亲子教育#一位好的妈妈能改变自己孩子的命运	母亲都是这样的，只是年幼的我们毫无察觉，谢谢妈妈。
第一次吃biangbiang面，面忒有嚼劲，赞！我在:alink	喜欢西安的面食吗？
传说中最嘴欠的鸟–鹈鹕「转」	莫名戳中我的笑点了噗哈哈哈
一个CEO给大学生的18点忠言，值得学习！	请大家花10分钟认真读完！比过去读10年要学得多！
相识满天下，知心能几人。（BY《增广贤文》）早安，各位。	那很有可能是自己的问题啊.
突然想到一个很严肃的学术性问题，是谁把60分定为及格的？	因为我们有百分之四十的人在政府相关部门需要被养着？
共和国生日快乐，那些为建立共和国牺牲的先烈不朽！	先烈知道今天是这样，都他妈能跳出来。
你们赏月。我在赏个毛线！	毛线！有人在赏你！
让你丫得瑟！笑死我了。	好吧……P的太有水准了……
明天就要出征了，这几天忙得一塌糊涂，终于收拾完了，歇会。	曾经何时这是我的梦到现在依旧是加油
找女博士做情妇，唉，说你什么好呢？	女博士怎么了，招你惹你啦。
苹果写给新入职员工的话。你感受到了什么？	Somethingbig.Somethingthatcouldn'thappenanywhereelse.
99%的男的看完这个视频会说“靠！”alink	靠这是个神马货日太牛了
周末愉快哦，晚安，好梦	今晚台风夜睡觉最舒服了
不就取个暖嘛，咱别这么销魂好吧！	介屁屁厥的。哈哈哈，表烤熟了哈！太销魂了
在荒郊野外拉shi，可是没带纸怎么办？神器有的是啊！用它！	裙子裙子👗'尿裤九
明天光棍节，你们怎么过？	天气预报说有大雪，所以呆在家里
“时尚就是”卡姿兰化妆品专卖店失火了，亮点自寻……	我要送你日不落的。
原来水中的鳄鱼是这样的，补脑了！「转」	这不是拼接的图吗。我靠。
今天中午自己做饭，吃一碗方便面，大家一起吃吧！	好吃啊！一桌子菜也不及这碗面！
iPhone床上四件套。膜拜啊！	用坏脑，一日对到黑，就连上床都用，真扑街
中国是这么形成的。（via历史解密网站）	蒙古帝国真心霸气了
等待太久得来的东西，多半已经不是当初自己想要的样子了。	曾经的不到的，现在不想要了
别试图改变别人，也别试图改变自己，改变自己就是被别人改变。	还真难改变别人啊！
快讯：黄金期货盘中再创历史新高，最高涨至1819.9美元/盎司。	乱世揣黄金，说得一点也不错啊！
哈勃岛---世界上唯一的粉红色沙滩，水清沙幼，真正的粉色沙砾！	哇粉红色星星眼了
你感觉你什么时候离朋友最远？「转」	他和别人在一起的时候。
周海滨租借至天津泰达俱乐部--alink	踢上球是最好的，支持
型男盛宴，孩纸们，自觉拖走吧。	想看的就看吧！提神，提神！
教你快速甄别科学与伪科学（来自脸书，渣翻译）	哈哈，如此说来，大部分科研都是伪科学
从大陆到香港工作的人你伤不起。「来自豆瓣」	老娘们上辈子就是折断了翅膀挥着臂膀的采蘑菇的爷们
觉得二人长得有点像	此女乃一哥们小时的邻居。靠！这又能说明什么呢？
温州日报女记者立功了！	温州日报的女记者估计现在已经激动的高潮了
『广州日报』18。25岁女性70%是大叔控alink	太现实了，寻求安全感的必然结果！
用五百年的冰和着威士忌，喝。	傻子，水还是几千年的水，能变吗？学学许家印认认真真搞足球。
麦蒂开始三分训练，刚才这组投篮29投25中！	这是职业球员的正常水准…CBA体测百分百的都有。
出差在外，今晚的《一些事一些情》节目有惊喜！	莫非你想玩远程连线直播呢招？智叔？
各位亲，看到这个我终于知道北京301医院番号的由来了。	崔，我怎么又被你无穷无尽的二逼气质给逗乐了呢
大家关注：中央新闻台焦点访谈在讲村医。	村医是一群特殊的医生
【马莉画室】思想者肖像：贺卫方alink	为嘛把老鹤搞成太监样？
告白姿势与告白姿势破解。	谁尼玛没事这样表白啊？！
今年春天终于拖拖拉拉的来了。	好美，喜欢你这个包包，什么牌子？
好象央视新楼附近又大火了	咋回4捏，找个道士看看。
我必须走了！我的星球需要我！（转）	小胖子只适合贴地飞行吧
澳洲大火后，考拉拦路讨水喝，非常可爱！	真可爱。你说这人怎么知道小考拉渴了呢？
井外有恶势力很危险，大家在里面最安全了！	让你们再嘲笑井底之蛙
诺基亚的使用口令须知(使用诺基亚手机的童鞋可以留着备用）	存，等我庚的广告粗来了就换
可能要自己一个人去台南演讲了。再不走就来不及了。	很喜欢您写的词，呵呵第一次这么靠前，吼吼
どのように私は私の头から悪いアイデアを削除できますか？	看懂了意思，不过前面どのように私は用的超怪的
你的眼睛欺骗了你的心……	3D版就不会被骗了，结论：全面了解才能认清事物的本质！
我们错过了多少美好的事物，就像是我们从未遇见他们一样。	我们忘记了多少美好的过去，就像从未拥有过一样。
“袖手旁观”——最神的就是那只踮着小脚看热闹的。	围观其实是一种本能。
“不眠之夜，我向月亮投降”——北岛《第五街》晚安。	看来往后北大师和顾大师的都要转了，精彩。
看我这招懒驴打滚！	反复看反复看反复看
我正在创作画！麻棒来讨亲亲	这次画的是什么啊？
哥，让我躺你身上睡会儿。#小鱼丸们相亲相爱#	嘴巴红红的，好想亲一下啊哈哈
我可以震动十天不休息！	牛B！更委婉的内涵。
如此强悍的睡觉方式。震惊！	这个记得盗墓笔记里有提到。原来是真的。
理工科的魅力！「人人网友罗英坤」	理工女表示鸭梨很大
我觉得非正常死亡的行业TOP10都有一个特点就是：要做很多PPT！	现在我看到ppt就想吐。
喝酒像喝汤，此人上班肯定在工商！	悲哀！恶心！控诉！
新浪微博是不是出故障了，微博的转发数和评论数都无法显示……	想看老娘的大腿根儿？交十块钱！
微软品牌形象广告不是一般的优秀alink	不仅仅是个广告……
今晚有大事发生（预计8点02发）	现在8点40了，可以宣布了
1989年的北京，那时候儿你多大？你想说点儿什么？	5岁，那个年代真好，只可惜一去不复返
这哥们几乎没有不会的项目，他就是我的男神——普京。(转)	人家曾经是克格勃特供，全能的男人！
给儿子剪一个黄晓明的新发型。	改天我也去剪、、、
打油诗版《出师表》【全文】alink	强烈建议收入语文课本完全讲解
以后再也没人给我们看病了。	很多人本来就没法看病。
人越是在困境里，越能够显现出自己的品质和精神。	夜再黑，也要相信有黎明
我真心想问北京哪里能处理比基尼区#美女照我去运动#	carezza巴西热蜡，在西大望路那边，有网站你可以先去网站看看
意大利U21的首发阵容，找到萨波纳拉了吗。	说超龄的，应该是u21以下小球迷
#没品新闻#继续走，继续失去，在我没有意识到的青春。	大半夜让不让人睡啊？
MSNBC和Fox预测金里奇赢了南卡初选，不是Romney太弱是什么？	无疑还是奥巴马另外4年。
有时候，你一定要带着一颗智慧的心去看新闻。	所以需要真理部对过期新闻进行回收销毁和再加工。
尼玛，这是一把小相公啊！——岳飞	这就是差一张牌的悲剧#一把改变历史的小相公#
有个故事很有启发，与大家共享……	其实，不愉快的时候，做点好事，真的是一种幸福。
如果你的男友沉迷于XBOX游戏，请买一件这样的T恤。	如果你的女朋友喜欢极品飞车游戏。
你喜欢许巍的歌儿吗？如果喜欢，能说说为什么吗？	得到鼓励，心情很平静！
有时候，你必须放手，才能明白它是否真的值得你拥有。	我喜欢你和小齐我10岁开始喜欢的现在22了哈哈
闪电镰刀，你一定没见过	莫非老天爷也想要打球了！
能离开的爱人便不是爱人，能分手的爱情就不是真爱。	希望你能看见，不要在伤心了·············
中秋节在《长城脚下公社》，山是那么青翠！	这是什么角度拍的。长城上？
七夕取消了单身顶一下！（转）	取消了，七夕取消了
我擦。这才是特种猫啊。「转」	玩PS2的超级喵星人！
#爱卡午休#这年头停个车就得这么神速…	成龙-我是谁-lanEVO4代
今天中午继续刀鱼、河豚、大黄鱼……	材料已经价值不菲，睇到都流晒口水
主人不要拦我。我要跟他拼了！	我靠！这个是狗啊？！
如果去年你的流量大部分浪费在这二个之上，请含泪转发！	微博QQ两手抓两手都要硬
负责企业的知识库管理，刚刚起步，杂乱无章ing。	我一直不是很明白，什么是企业的知识库？
新浪微博关于访问故障的致歉声明alink	以后升级能事先通知下么。
令人称奇的手绘艺术！这个太牛了！	栩栩如生！艺术点亮生活！
那个让我微博会员图标变彩色的人你不出声我也只好跟你说晚安	说站出来的话可以考虑…
算算自己离判刑还有多久	我能想到最浪漫的事就是陪你一起坐牢
外向孤独患者的8个症状，你中了几条？。（转）	我是中毒很深啊。全中了啊
还记得它的名字是啥么？	小时候经常买，论斤称的
可恶！那个臭矮子快放开妹子！【FB:alink】	狩子大人。快收了他
北京六环房价破2万元大关一年涨幅超30%！	以后防毒面具应该还的贵吧？
上甘岭战役进入战略反攻阶段！赌破150的准备裸奔或请客吧	我是想着破150就割肉的。现在已经盈利
用不用那么多三分？雷霆你们的三分呢？	要是马刺来打应该会好些至少不会被干的这么惨啊！
某些人，只想念不联系	其实想联系，只喺唔知点开口。
发表了博文《芭莎电影创刊号——李冰冰》-alink	你每次都不会让我失望的
一场秋雨一重色，红叶黄花秋景宽。早上好，各位！	就让我一辈子都呆在这个地方吧，上帝
突然发现：现在的生活才叫“乐活”！	只要愿意，每天都可以乐活人间
#颜色#有种夏天叫做孔雀蓝！	还是喜欢以前图片的形式！
#郑在晒晚餐#吃晚饭了吗？在家吃还是在外边吃？	想问郑大哥，每次只看到一部分的是蒜瓣吗？
如果爱不以水的形式存在，它变成了冰，变成了雾，它还是爱吗。	庄主莫装逼………谢谢
我越来越失去了礼让行人的美德我在这里:alink	欸，我还行呢，老是让人。可是能不能少一点中国式过马路
英国BBC评出的人生50个必去圣地。有生之年，谁能全部走遍？	有生之年，我要去个遍！
等到我老了，我就想住这样的房子！。	老了，我就建一个破茅草屋
松花江畔，灯光闪闪，波光粼粼，清风徐徐。	欢迎贾老师下次来吉林，有时间去松花湖游玩，吃美味鱼餐.
坚决反对对民主的朝鲜指手画脚，干涉禅让。	这可不是禅让，是接班。
企盼的眼神！柔滑的毛发！好萌啊！	倒。萌是萌！但是，，你想对她做什么。！
最近北京感冒发烧的特多吧？特别是小孩子？	前天我儿子发烧了。
时光带走了那个凶巴巴的她……（via：热带猫顾顾）	可不可以不要带走她
感谢大家的祝福，也希望所有的人都身体健康！	对你的爱不多说了明了
即使是加长豪车，也有过不了的坎。	哎呀，这车不好，只能在平路上开
历史文档：1995年贝志城等人收到的电邮回信。alink	冒昧问一句，这个邮件不是全部吧？有全稿上传吗？谢谢
史上最强大&最简易的防盗系统！	每次发英语我都看不懂，泪
每一个你讨厌的现在，都有一个不够努力的曾经。	数一数这样的曾经。想一想那样的未来。
这是个公益广告，减肥吧！胖孩纸的忧桑谁人能懂。	戳中笑点这是什么心态
#每日一诗词#纵使簪花同醉酒，终不似少年游。	昔日豪言创伟业，今时悲叹度余生。
#海贼王#给你一次机会你最想痛扁的海贼王人物是谁？	先是黑胡子，再是红狗
【给（对先生）的一封信】——未来不可知，你也不可知。	未来不可知，你也不可知
大巴车离开帝都，朝着木兰围场的方向，疾驰。	大家都在发路上的风景严重支持，多发点
给自己一个LV，不如给自己一个longvacation。	能和父母一起外出度假该有多好啊，晒太阳！
不跟随，不解释，不媚俗，做自己.	不跟随，不解释，不媚俗，做自己.
这辈子第一搭到hellokitty飞机，全部都是她	你好，你终于结婚了，不过我也结了。
你会画画？那这家伙至少比你强两倍……	阮阮知道他画的谁太牛逼了！
主人对不起，我把假的摔碎了……	要求发红色工作制服
早，昨天有谁被大风调戏了	早。今天上海天气好好啊。地陪桑不起啊。劳心劳力。
在洛杉矶和孩子们一起吃海鲜大餐，不用刀叉、筷子，只用手。	是谁给郎导拍照的呢
【真心话大冒险】假如你喜欢的人醉倒在你床上，你会怎么做？	做好酒后所需的一切，看着她的难受而心痛。
一句话定生死，你知道他说了什么话吗？解答在这：alink	你不曾给我一次回眸，我却始终在对你微笑。
敬君子方显有德，怕小人不算无能。	如何与地位高的小人共处？
人民的子弟，钢铁的长城，八一，向你致敬！	长腿！帅哥全去当兵了，哼！
快乐女生今天的节目彩排开始.	今年我都没看过！不过支持你！很喜欢你啊！
首位80后国家领导人横空出世！	哈哈，我们这兴80后处级干部。
看到这个物流结果，我震惊了！	alink请阁下投三号梁振中海贼王摊位
爆笑体育开始啦，别换台哦！	爆笑体育绝对是央视（不算新闻联播的情况下）收视率最高的节目
说走就走，是人生最华美的奢侈，也是最灿烂的自由。（转）	送给自己，希望一直有这样说走就走的心。
小时候，快乐是多么廉价的东西。	可恶的教育制度，剥夺了孩子们多少童年的快乐啊！
喝下一罐可乐后1小时内身体的反应。（via：_方方土）	为嘛我整天喝的时候瘦的根杆子是的，现在不爱喝了反而胖了呢
今天午餐讨论的主题是：那些给我们造成童年阴影的鬼故事	小时候，在晒谷场放映投影电影，最深刻的是恐怖片《画皮》。
半场结束，大连阿尔滨2-0领先北京国安。	下半场这么踢下去，4、5：0都有可能，自己看着办吧。
从2000-2012克里斯蒂安·贝尔体重的变化，真是个好演员！「转」	五十五这个公斤不怕自己随时死翘翘吗
看二狗哥微博，懂得爱，学会爱	如果这就是爱，一起来搞基
这两条微博连在一起发是要闹哪样。＝＝	。我觉得吧！你真应该豁出去了！哈哈哈哈！
威尼斯的夜晚，贡多拉静静地躺在水面上。	这水咋这色咧？还比不上咱中国的凤凰！
审计的孩纸，你们是不是这样的……	即便这样我依然喜欢这个行业
将来的你，一定会感谢现在拼命努力的你。	Right，哥现在就是一拼命三郎。
美的令人窒息的门口装饰。	最后一个是现实中的吗
小时候抠过瓶盖里面的胶皮垫，我也不多说了，转吧。	不得不说，干过这个，好二
有时，幸福就是意犹未尽…	有时幸福就像数手指…12345…6789…10
给我一个理由，我就不吃你！	我我我。我不知道。==
不要放弃，最终你会发现一切都是值得的。	最终的快感只有自己知
在赴约的路上？你们懂的。alink	次数太多容易坏。古人真是不容易啊。
可爱的咖啡，差点舍不得喝！	现在的我刚刚下班，希望明天又是美好的一天！加油
我在广州，二十三岁，想去马尔代夫，一个人。	我一个人，想去沙漠，不是一个人。
怪不得学生不让带手机。	我真的忍不住笑了，我真的忍不住转了偷笑]
单曲循环，其实是听着自己的心情。	每一次的单曲循环听的都是自己
今儿姐真高兴。决定带病喝两口。	真心喜欢你。宁波人谢谢你！
其实我对出家人玩微博一直很困惑。	与常人的区別小了。
据说所有人都有一个毛病，越是喜欢谁，越爱欺负谁。转	越是喜欢谁，越爱欺负谁。
从孩子的画里，你看到了什么？早安。	所以，孩子面前还是闭上我们吵架的臭嘴吧！
喜欢吃烤红薯的童鞋举个爪，以表咱有个共同喜好！	抢完康佳的东西就快睡吧。
车位是这样挤出来的，奇葩司机是这样停车的。alink	欧洲停车本来就这样的。手刹都不拉紧的。
一开始作曲，就觉得自己的音乐素养是渣。	还是想知道梁直是如何作曲的。
陪伴与懂得，比爱情更加重要。	陪伴与懂得，本身不就是爱么。
兔年就要到了，快来喂小兔子胡萝卜吧！	和之前的那张喂熊猫吃竹子，有异曲同工之妙
呀爪爪又不干净了，舔舔！	可爱，，太可爱了吧
当年，你们有迷恋她们么？	如果你愿意我可以永远像春天那样美丽。
全国处级以上干部财产内部申报已经开始。	这是双刃剑，如果上头好就利于改革，如果上头不好就会相反。
#马刺VS快船#马刺102-99快船，4-0淘汰对手晋级西部决赛！	马刺坐等雷霆哈哈睇西部决赛完全系享受
大哥，赢了就赢了，咱能低调点么。#搞笑#	就是嘛，胜不骄败不馁！才是奥林匹克精神的宗旨
雪地里雪做的香槟台，浪漫🌹！	正在举行什么仪式呢？
1号店六一零食疯抢ing，低至1元：(链接在评论里额)	你总是用没有的商品发图片啊！
要登机啦！#问泉#下周再续哈！	周周坚持一事，不易！继续吧
请问今天是白羊座还是金牛座？希特勒是白羊还是金牛？	白羊金牛双重性格兼备，按理是金牛
#郑在提醒吃早餐#别忘了吃早饭。餐桌上这段文字出自哪部作品？	图片小了点儿，字看不清楚。
运营商的哪个互联网业务是用来泡妞的？	妈妈（运营商）说，女人是老虎不让泡。
一位技术牛人手工制作的风扇电子钟，好炫酷啊！	这种……led技术已经不稀奇了……
【体重与抗风级的关系】看看你能抵御几级台风	千万别给大风刮跑了
朋友是什么？朋友是居住在不同躯体里的同一个灵魂。	虽然不言不语，叫人难忘记。你的眼神，友情天地。
看看111年以前先人幻想的未来科学走向	第六幅图里还有清朝人？
宠辱不惊，看庭前花开花落；去留无意，望天空云卷云舒。	你在看什么呢？只有站得高才能看得远吗？还是累了靠一下栏杆？
马云似乎发誓把他的主题演讲弄成《我有一个梦想》。	回复彭薇永远的太阳机器人:马大哈，云里雾里！更贴切！
Blobfish，一种罕见的深海鱼。	MIB3里出现过，吴园餐厅！
日本超红的心理测试，准到爆！	有一些准！有一些不准！
岁月是把杀猪刀啊。你还认得他们么？「图转」	哎哎···还是蛮帅的
我个人以为余华凭许三观比莫言任何一本都更有资格拿诺奖。	余华是个真正讲故事讲得好的中国作家。
赖床是对假期最起码的尊重。	我居然连最起码的尊重都没有给假期。555555555
午餐来了（上海丽悦酒店西餐厅）alink	来杭州一起晚餐如何？
今天打新疆，大家应该解放思想放手一博。	加油啊小紧张已经不行了很是紧张
大型敞棚TAXI，不少人的回忆吧？	当年就是坐它游的鲸鱼沟
暴走漫画6月神秘活动，敬请关注。	难道又是神马X月我布鲁？
离开杭州前，总算西湖了。说好的赵雅芝呢？	真正的白蛇style可能是苑琼丹演的石榴姐
父亲华揽洪简历（长微博）。	祝您的父亲安康吉祥
不喜欢我你可以侮辱我，但请你不要打我，	为你的骨气赞一个！
欧洲杯观战指南！喜欢的朋友收一个。	好可惜，没有时间看了！
严寒的天气不会阻止前进，心情的冻结却会。早安。	早安。好久没有问好了。
＂把生命的每一天当作最后一天来过，保持对生命的敏感。＂早安	是让我们每天都生活在末日的恐怖中吗？
梁博OR黄勇？你会选择谁？alink	我可以说，我不认识他俩么
印度人吃什么菜？集市随手拍。	这些菜在天朝的话，早被城管叔叔收拾了
我们凤凰卫视已经在那霸码头架好卫星，等待押解船入港。	嗯，吕宁思睿智，凤凰威武。
吵吵吵，凉茶创始人后人都出来了！	王老吉说白了就是一个糖水么。好甜。
黑色冰激凌，会是什么味道呢？你试过吗？	我也猜想是黑芝麻，难不成是竹炭？
这货居然拔了根自己的毛在那挠痒痒「转」	果然要对自己下手狠一点，才能得到幸福啊……
给我说一句你听过的最温暖的话。	姐姐对我说:困难会过去的！
动漫界十三大名宠，你萌哪一个呢？「人人网友」	当然是黑崎一护家的魂，然后是龙猫
【带花纹的鸡蛋】超有爱啊。！童鞋们快来试试。	连个鸡蛋都搞得那么烦
来，击个掌！哎、哎呀……	这貌似和某个人有点像
亲。这个好评给的够实在	……才二十万么，这员工是多大的牺牲啊
他们说这种照片风格叫“在云端”，我觉得差不多。	请问最高的书架上的书怎么能够得着？
#虎扑图片#再见这一幕只能在梦中	这三人都健康现在玫瑰花园会是怎么样的场景啊
比较萌的胸太小，胸大的又太蠢，此事古难全。	萌，胸大。但是也蠢。
如何与程序员沟通。「转」	这个真的不是这样滴
老娘的车都敢拖，看谁拖谁，笑死我了，呵呵。alink	“定无来，定无来”！上海额闹
感恩节快乐！感谢命运和你们•••	感恩节快乐！感恩一切！
圆圈在你里面被创造出来，你就自由了。Granada	这张曝光曝得很精准啊
iPhone5概念视频！太牛XXX了。alink	真的很薄。概念的太牛了。
白天拍戏，晚上做主持，这年头拼的就是综合素质。	真能扯，你松么时候见郎叔叔晚上主持过呀？我细木有见过
不管生长在哪里，都要有飞翔的姿态。	不管年纪多大，都要有飞翔的心态
周杰伦十二年来的变化。「转」	虽然你丑，但是在我心中最帅，，，
#520#每天都要开心的过噢！	这个可以吃吗？该不会是香皂吧
枪声越来越激烈，埃及的晚上开始了，今天的枪战时间开始提前	希望同胞能平安归来！
心累了，不如出去走走。	心倒没有累，但是想出去走走。或许是为了暂时避开这样的现实……
偶不是狗，伦家是灰机，起灰。#狗##趣图#	好胖啊，平衡力不错
就算是葱，也要做个内心强大的葱！	这是个外在强大的葱！
闹钟设成这样都没办法起床的同学出来冒个泡！。	像从我手机复制的一样。哈哈哈哈
真正的幸福，要有尊严和自由。晚安。	无休止的管对方或怀疑，过度干预对方生活都不妥，即使结婚了！
我是听林志炫的歌长大的，哥哥姐姐你们不要黑他好吗！	你不是说女屌丝才看
【旅美图】一日游杭州西湖雪景alink	漂亮，很想亲自去看看alink
给合作的SoundDesigner的DVD拷贝	好想看啊momo！星星眼*o*
北京的天啊，像不像电影里的寂静岭，早晚有一天被毒死	以前真没这样，尤其在夏天
朋友们早上好，今天的空气质量。	在韩国还关心国内的空气质量，老潘行呀。
雨中睡睡懒觉，花前做做情诗。篱前摘把扁豆，回家炒个肉丝。	下午破事做完，陪着同学聊天。都说老了咋办，老树你说看看。
你既然认准了这条路，又何必在意要走多久。	如果认准了这条路，只在意和谁一起走可以到尽头。
面子到底多少钱一斤我们为什么要在乎别人的看法	这种斑点可去广州陆军医院去掉！不留印！我有朋友试过
再度聚在一起了！熟悉的感觉！锁定十点名人堂	andy赶紧的做吧，重现黑涩会，好期待好期待好期待
产品，是用来自恋的；商品，是用来赚钱的。	产品是自己喜欢的，商品是客户喜欢的。
黄万里的预言开始被验证。	政绩是出来了，可惜失了民心，散了民财。
这。这是神马情况呢？！	longtimenosee.thinkdieme.
出来混，总要偶尔换个头像什么的。	这个头像好，醒目多了。
传统文化的落寞。是这个世界人心太浮躁了？	长大了才发现传统文化的珍贵
海景房不用买，等一等就会有的（2013年8月拍摄于香山，北京）	海景房，我的梦。2013年看来提前实现了！
小宝贝肿么了，是失恋了还是被人期负了。	哎呦，泪眼汪汪的。萌爆了
能用60年的那种举手表决器在哪里卖呀？亲？	传说三胖投篮百发百中，是真的么。
听到一些事，明明不相干的，也会在心中拐好几个弯想到你。	我只是还没来得及承认自己，
日本核辐射之后的老鼠终于进化了。神兽！alink	宠物小精灵能未卜先知么？
大家早！我要去神医那治疗鸟	那么早啊，你哪里受伤了啊
谢耳朵和卷福的搞笑对白！「转」	哈哈哈哈Smartisthenewsexy！
第93分钟，利马再得一张黄牌，累计两张黄牌被罚下场。	次奥，国安这是要崩盘啊
网曝高院法官赵明华有情妇、多套房产alink	反腐的难点是，反了亡党，不反亡国。
这是我见过最有诱惑力的招聘启事！	没记错是束河一客栈门前的牌
【推荐#人生必看的100部电影#】点击“查看原图”可看到大图。	低俗小说每次都没看完！11
大家好，现在是报复社会时间。我在这里:alink	欢迎看看四川夜宵，那才是报复社会……
你所知道的不要全说，你所看到的不要全信。早安。	这是对的，你认为的流氓或许是好人，你认为的好人其实是流氓
据说转发蝴蝶树的人，就会保佑你在2012年里好运久久。	我们都要好运久久。
图片分享！猜猜看：这哥们身后的飞机派甚么用场？	直升机呀？不是用来飞的么？
【装修前必须注意的事项】不要等到装修后，才明白这些事儿。	配饰装点——让家更有味道
上海的天也是阴云密布。但秋色尚不浓。	两位空中心交。老死不相见吗、？
有童鞋能看出是哪位老师的签名，并说出他的代表作吗？	有奖品吗？猜对有桃子吗？
【致全体华润员工的一封信】	相信华润是清白的大家顶起来啊，呼呼呼呼
《成长的烦恼》剧组1987-2011，小时候最爱看的电视剧之一！	幸福一家子，小时候的最爱。
我独自度过了太多时光，沉默已成一种习惯。----柏瑞尔·马卡姆	嗯嗯。越来越沉默，感觉人也傻了
看看神马才叫有房有车。	羡慕嫉妒恨啊，太帅了
世界上第一个海底度假村——斐济海神。想去住住吗？	好想，半夜醒来有鲨鱼正看着我！好酷！
没有所谓失败，除非你不再尝试。——哈伯德早安！	没有所谓失败，除非你不再尝试
9号弗雷德一一躺射，破门！1分39秒alink	告别大都市，哥要下乡了！
鲁莽会使人后悔一阵子，但懦弱会让人后悔一辈子。	一使一让现玄机啊，不错！
各位推荐一下现在有什么美剧比较好看啊？呵呵	美国处男一至六集看完笑到你肚痛
中国各省市历史名人（值得收藏），欢迎补充。	山西还有胡耀邦，徐向前，闫锡山，薄一波
再乱买零食就剁手，先从不拦着我的人开始！	为啥看你微博我都会笑呢？#武艺百变大咖秀#
圣安东尼奥疯狂三分雨，马刺第三场击溃热火2-1领先！	尼尔和格林今天帅爆了。肯定受过翠西的秘密训练。
这降价降的太坑爹了！诺基亚用户你们伤的起吗？	应该需要入网换号并且绑定套餐吧，补贴价格没多大参考价值
#看图猜电影#这是哪部电影的神兽？	一看就知道是幽灵公主……
吃货们，你眼中的中国是不是这样的？	各位还差哪没吃过？
人家都说二月春风似剪刀，这特么三月狂风似青龙偃月刀	妹的、深有感触、、
先来看看布冯神奇的两连扑！	世界级门神不是吹的
周末大家都不闲着，路过，看到苏老师在上课，偷拍一个。	昨天你没有来参加打球吧，整个球队水平降道另一个档次。
#NBA酷图#基德表情三连拍，好萌的主教练！	会不会教着教着就说，把球给我，直接亲身上阵
天涯上的蛋糕帖，吃蛋糕毁三观，以后都不想吃蛋糕了。！「转」	一定要转，太欢乐了，哈哈
［联合国图片］刚果民主共和国·激战过后	激战过后，抱歉，我走位了
在梦里翻看一本百年后的史书，后来我就醒了，满身冷汗。	中国自2002年之后再次进入世界杯决赛圈(决赛场地：通州体育中心）
这个图，值得珍藏，永远的经典！（转）	过儿。姑姑。过儿。姑姑。那时候觉得小龙女绝对是最美的。
原来蓝莓是这么长的，好漂亮！	不论是青春还是成熟都吸引人眼球。
宇宙篇：你从没见过的23张图，让你有一种莫名的恐惧。	只能说一切皆有可能！
湖北省委书记李鸿忠在十堰站赶火车。	需要多几个这样的领袖
【历史深圳】1982年的深圳南大道	十年后的92年有了现在的深南大道，此前确实如此。
原来这样可以拯救地球的，再也不用担心2012了。	再没人能阻止我拯救地球啦
上来一看，都在等权威消息。	哈哈，是人民网的粉丝都涨六万了！
我想不管这个世界如何变化，人们还是愿意相信美好。	爬爬晚安愿你做个美好的梦
#孤独之心俱乐部#有时候我就想一个人在自己的小黑屋里呆着。	我以前小时候也用我家的冰箱盒子弄过小房子，好喜欢这种感觉
在这里见识了太多生死离别，大家真是应该珍惜健康珍惜身边人。	嗯。北京暴雨。被淹的很惨。你还好么。
【巴勒莫-米兰】进球了！伊布！	此球小黑功不可没！
有多少同学，直到十几年后的今天，依然看不懂扫雷游戏？	我是才知道还有这样的游戏。也不知道这是在干嘛
冬天已经到来，春天还会远吗？——雪莱晚安，各位。	Ifwintercomes，willspringbefarbehind？
回来晚了。给看一看吧，明天再吃。糟糕，竟然敢抢！	给汪吃了算了吧……
但从食品安全角度来说，这年头，吃鸡比吃鸡巴危险多了。	后者只限于舔舔、咂咂及吞食小部分分泌物好么，不管饱啊
很经典的婚前婚后。	感情就是这么个意思……
今晚西班牙可能击败意大利卫冕。	今晚，那就开心死了。
【两会第一雷】人大代表：应将贪污10万判10年以上改为1年以上。	我操你们吗，应该枪毙！
林徽因真正的平静，不是避开车马喧嚣，而是在心中修篱种菊。	小林，看在你的面子上，这话我转了。
洪水后，一张让人无法不感动的照片	你有没有想过这样真的能更方便的过桥么
只有父母会感觉没了你，没了全世界。	有妈妈的地方才是我的家
原来蓝莓是这样长的	原来蓝莓是这样长的
＃有奖竞猜＃郭美美与红会的共同特点是什么？	都有G点，都是黑木耳
32分钟本特利追回一球！武汉卓尔1-3恒大！直播间：alink	今天恐怕要被打花了
傻逼样的去坚持，自会看见牛逼的结果。	毕业考、等看结果吧！
宋祖英的造型师基本可以拉出午门了	＂拖泥大师＂。我们想「拖你」出去乱棍「打死」！
还记得这个小屁孩儿吗？恩。他长大了	还是个可爱的小胖纸
超有爱的。楼梯什么的最喜欢了。	好环保，节约空间，真聪明！
深谙世故却不世故，才是最善良的成熟。	想却不能，恐怕就是不成熟吧
爱情，是什么？一位清华大学教授写的，说的太对了！（转）	给你，你会看得见，我睡了。
邵佳一：俄罗斯今天应该不会输，捷克今天应该能得首胜。	越来越怀疑波兰会爆冷击败俄罗斯。
16岁时的安吉丽娜·朱莉（AngelinaJolie）。	我第一感觉就是转发
谷歌开送了，所有人都有：手机+平板+加Q球。	这。我也要，哭了！
世间最痛苦的莫过于此。「转」	世间最痛苦的莫过于此
严禁吸烟！好吧，大大军借你的烟拍一张咧：））	很美，这是代言什么服装还是杂志的宣传照啊？
据说，本报这个标题成了一个冷笑话。	软柿子味道不咋好啊
两问：房价会不会涨？接下来还有什么重招？	北京东四环边上二手房已经涨到去年年底的水平了
有一天，猪统治了世界，它也会这么干。	猪猪乐园会喜欢这张
这是反弹么？这是牛市。自1664起，1949重启。	病的不轻啊！赶紧去看医生吧。
存的一组北极狐的照，真是漂亮的生物。「via巢中落满稻草灰」	正在看「诛仙」，想起了九尾天狐小白。
黑天鹅蛋糕。摄影爱好者的挚爱！	这是什么东东啊，可以吃吗？
#六一儿童节#《生活大爆炸》主演的童年照	喜欢美瞳的请关注我！
笨蛋，按摩都不会！图片来自imgur	这两只成精了嘛，就差没幻化成人形了。！
领口罩和板蓝根去鸟。	口罩还是可以，板蓝根真有用吗？
我能说！太，牛，逼，了！	是NBA的篮球打的太牛X了，还是“费用忒大了？”
用一个地名证明，你在苏州生活过。我先来：杨枝东路。	苏州的路名都很有特色，喜欢！
南京的猫，走路很霸气呀	这不是我家绅士么？
难道这招就是失传已久的终极必杀技“翻云倒海”？震惊鸟。	终极绝杀：晕头转向
这就是你该珍惜的白羊座！	我都笑了跟狮子座的有差别么
看到这幅地图，脑海中禁不住浮想起“卖锅贼”这三个大字！	谁信谁傻逼系列又出新作啦？
地球已经阻止不了她了！稳稳滴。	恰到好处，物尽其用.
莫耶斯和维迪奇在发布会现场，他正式宣布了鲁尼留队！	什么娜娜破车表妹宇宙银河都给我死开！
孩子，你也太凶残了，请用一句固话形容下你的心情。	孩子。你和贝爷是什么关系
当下一个是你时，有些事就没有那么好笑了。	我想笑但是笑不出来。
1938年蒋介石周恩来武昌会谈全文原件十八页（第一页）	蝇头小楷写好了也很拉风啊
马化腾：中国要杜绝山寨文化需自主创新。	山寨王要脱山寨啊……
我也要醬的猫被子！	Badforbabieswithasthma
奥迪遭砸场子？成都车展。	现场的朋友，播报一下呢？
史上最牛抖奶哥，膜拜这随心所欲的乳力！alink	哇塞这是肿么练的呢？
唉，审美观真的过时啦？	不要觉得自己审美Out了，可能你从来没In过
经典是对潮流的不断重塑，而潮流是对经典的致敬和传承！	支持李小龙，中国的一个传奇。
这水清澈得像船漂在空中一样。	曾经看过的海。是否还是如此清澈
今天上午某考场外一景。转	下面的课本不是大学的么？
教下大家怎么将你的键盘大扫除。超级实用哦！	明天闲来无事一定要试试
电梯里。第一次一个人占据大半空间，这，是要人减肥吗？	张老师有次从我身边走过，气场感觉太强大了！
【侃电影】你最欣赏的电影大师是哪位？	你敢不敢换个照片？
北鼻蜡烛不是这么吹滴。	传说中的吞火绝技。
如果你累了，请你回头，我一直都在。	如果你累了，请你回头，我一直都在
你知道裙子的长短怎样表达吗？（转）	明白HR为什么要求dressingcode了
刚被救活，又被艳丽妖娆整死。	真的能救人吗？有点小担心
开学后，我觉得自己思考得最多的三个问题是……	点开之前我以为有一个一定是吃什么，没想到三个都是吃什么><
清晨的鼓浪屿依然是可爱的，在过于众多的恶俗店醒来之前。	话说小摊贩真是无孔不入
生活趣味源自创意，高品质生活需用心经营！	高品质生活需用心经营
上课想吃烧烤怎么办？	哈哈哈哈哈哈哈哈……这样都行……
小麦成了装饰。也是菜盘里的一种美。	光摆造型没数量，够谁吃。这饭店早晚黄。
大家好，我是来打酱油的。	年轻时候的MichealFinley实体素质也可算是无解！绝对不是酱油帝啊
#315在行动#第一个目标是苹果。	三星笑了，小米也笑了，htc也笑了
哥马上就不用骑小油菜啦啊哈哈哈哈哈！	少点生气啊不然都要奔天国了
生命中，再无聊的时光，也都是限量版！	生命中的一切都是限量版的
人们总说时间会改变一切，但实际上你自己必须去改变一切。	感觉字写的潦草了……
外国牛人用5800枚镜子做成的死光，太牛啦！alink	妹的。真是干嘛的都有！
每天都扫出一大撮一大撮的头发……该怎么拯救呀。via米兹大小姐	同感，理发师说我的头发越来越少了！
早安！我终于要準备睡觉了。时差困爆	早安，我整夜都在车里度过
终于在波士顿的chinatown吃到了火锅。	看着像肥牛火锅城？
新几内亚天堂鸟，又叫极乐鸟，这货太萌了！	诶呀大清早的忒喜庆了
时光静好，与君语；细水流年，与君同；繁华落尽，与君老。	执子之手，与子偕老！
看看亚马逊和申通在忙碌的时候的区别。（转）	派件速度无法保障，哪里还称得上“快递”
换一个面貌.换一种心情。又是一个SunnyDaY	一点浩然气，千里快哉风
现在枪手少了他真的打不开局面？	这不是吸血鬼日记么
如果有天你手机停机了，谁会为你充值呢？	曾今铃声设置成停机的铃声，我妈给我冲了100多话费！
这你总不好搞错了吧，这是猪肉！	买错，肯定是瞎了！
转到自己微博里，不开心的时候跟着做一遍，你就会开心了。	不开心的时候跟着做一遍，你就会开心了。
其实女孩要的东西很简单，但大多数男生都不懂……viaecho小茵茵	大多数男人都懂。现在的女孩子都变质了。
#旅行贴士#魔术头巾的N种戴法和用途！旅行必备呀！	厉害厉害，要备一条才行。
水原希子黑白复古写真。	不知道为啥，有点奥黛丽赫本的赶脚
【推荐#人生必看的100部电影#】点击“查看原图”可看到大图。	看过十几二十个准备把剩下的全看了
回到家把身上的零七八碎都掏出来了	请问蝈蝈罐是本长儿吗？另：观音体态不错
胖纸唯一的好处就是人多的时候可以做副驾驶。	扣系，副驾最不安全
如果中国迁都，您认为迁到什么地方合适？	越新的城市越好，我怕老城被拆得面目全非。
新版滴红楼梦大家都看过吧！	讨厌，硬要给人家戴个丑帽子
谁说大姚不漂亮我跟谁急	这是谁拍的！怎么这么美美美美美！
翻到这张照片，想定做一件旗袍，不知道北京哪里比较好？	好思想好美女好性感
都来谈谈你们的欧美女神是谁吧。	BritneyNicoleKidmanLima
走过如果，都不要错过。	错过就是永恒。大宝，晚安。
原来，四位导师从一开始就不是选最好，而是选最适合自己的歌手	哈哈我刚也意识到了许老师
汗，看小图的时候还以为是容嬷嬷。「转」	苍茫的天涯是我的爱，绵绵的青山脚下花正开。耶耶切克闹
好大一只！——图来自imgur	这人也长得太小了吧。
#马刺VS勇士#库里在马刺各球员防守下的投篮情况，格林亮了。	帕克这求太匪夷所思
一只羊居然这么腹黑。这让人情何以堪啊。	还退两步冲个次，哈哈哈哈哈哈。这羊太逗了
【乱弹】以前五一长假是休息7天，现在五一长假是工作7天……	就是，我们更悲催，工作九天。这是怎么啦
像这么超凡脱俗的小学生已经不多见了。「转」	如果不是红领巾，我以为是日本少年
据央视刚刚报道，神八飞船发射时间确定为今日5时58分10秒。	腾讯说是七秒，到底
猎人出没，熊请注意！#为早收工，卖个萌#	你暴露了快快报上猎人名号。！
以前的棉花糖都弱爆了好么！	好漂亮的棉花糖吖。好想吃。
昨天写的贝克汉姆，长微博贴出。	记忆里筑一座灯塔，回望时照亮来时路。
据说为了画杜甫，语文课本都脱销了。	都是淫才啊。哈哈，当年我也画过滴
我结4，韩善华面前出现的不是光熙，而是林时皖alink	时完真不错阿，帅哥呀
脸上没有一颗痘印的感觉真好，真心推荐WIS：alink	唉，我的很多都是十年前的痘印了，用几支多久能治好？
刘欢老师表情的意思是：您的QQ正在登录中。「via地空捣蛋」	乃们好坏！这女生真的不错，很有国际范儿！
一直觉得她，唱功很厉害很厉害，但感动不了我。	好嗓子，，，但嗓音还是有缺陷，比真正的天后还有差距。
我做错了吗？急！在线等	大哥，有点职业道德可好？！
万圣节快乐。儿子好动做Dash太适合了。	幸福的家庭总是相似的，向你们学习！
创意字体设计——舞（图转）	亲，早安。好个舞者
慕尼黑中国古建筑模型展	仿佛看到了那不朽的魂。
#下午茶#不要去打扰别人的幸福。<转>	幸福只是各人自己的主观感受，不要打扰别人！
难得偷闲一个人出来按摩，哈哈，人生本该如此☁	挺好的.有时候是该对自己好一点
生活越来越像生活，天空则越来越不像天空了	最后，生活一定也不像生活了·············
县太爷的女儿……是你们不懂导演的内涵！	我和我的小火伴都觉得博主智力有障碍
如果你放不下那个错的人，那么你永远也找不到那个对的人	是吗？可能不是那么一回事吧！
如果你在背后议论我，那只能说明，我活的明显要比你精彩许多。	如果你在背后议论我那只能说明我活的明显要比你精彩许多
移动和苹果合作了，我又不相信爱情了！	移动一直时备胎，这次是给个名分了
也门小姐选美前八强。您觉得几号佳丽最美？（转）	选举为什么还要穿黑色的衣服
我说“春风又绿江南岸”，你说________________。坐等神句。	百雨新红荷泽园。---------百雨金牡丹别名
水蓝色海扬帆去我又长大了！	哈、确实很可爱、、、
出发杭州了，希望能顺利通过季后赛首轮	肯定能啊！北京今年要打总决赛
我跳。呀哟。这么点点高，你都跳不下去。	滚滚真的是偶天朝第一萌物啊
终于到孟买了。连飞带转机一共十六个小时，够到美国了呵。	真羡慕，可以到处飞
今天早上九点出发，明天早上十点出发，可以多睡一个小时。	你好可爱！快休息啦！晚安！
知道真相眼泪掉下来。(转）	红孩儿是赵欣培演的好吗
近来特别累，活得也潦草。真想睡过去，不醒多么好！	这情绪是季节性的吗，我也是
第68分钟，皮克放倒内马尔吃到红牌	一觉醒来，怎么搞的得这么惨！
和大家分享围巾戴给我们的美丽你会几种方法呢？	看了😊💛💙💜💚❤😱都好看👀会配衣衣的话👗💅💐
发表了博文《嘉人美妆孙俪。》-alink	第一眼看过去，真没觉得好看，或许她不适合这个妆吧
好久没坐火车了，西客站候车室也大变样。	老校长还能做火车，身体真令我们学子钦佩
早。为简单美好的幸福，加油。	自由王国！神仙架到！
强壮的心脏是必须经过多年的训练	当来姚明时的火箭才够刺激呢。
今天比前两天都疼…脊椎中间，受伤点开始淤青…我了个去…	小姑娘，好好保重身体。
我不懂什么叫爱，我只知道离不开。（转）	好像和我拍到的一只是一个种类
祭祀李纲的祠堂，我在≪两宋风云≫里讲过的。	李纲李伯纪不知道这地方在哪
早起困难若能算尚未初老的表征倒不失为一大安慰。alink	年轻人的体征，但得像老年人一样早起
儿子为妈妈做的桌面。又搞笑又有爱。（图转）	哇哈哈我也要做个，哇哈哈
视频来啦。CosplayHighlights2011（夜宵，吃完睡）alink	歌曲叫什么名字哦？好帅啊。
原来咖啡是这样分类的，太直观了！收！	大爱玛琪雅朵，在意大利也就1.5欧一杯.
#案情通报#【长沙市东来苑小区发生一起案件】，详见下图长微博	佩服，你干了大家想干却不敢干的事
琢磨先生脱口秀-朝鲜射了	盼星星盼月亮总算盼来了琢磨的脱口秀
检验美国高中生英文水平的100个单词，你认识几个	一个都不认识还不是随便考130的高考英语。
苏宁张近东最新接受商业杂志采访，公开批评马云退休。	面相上就输给马云了，好意思得瑟。
新浪微博控粉三大帮派图解	表示爪机看不清。
“坚决拥护中国共产党，热爱祖国、热爱家乡。”——王林大师说	再加上热爱美女热爱钱。
今日动画片回忆集锦VS二十年后动画片回忆集锦「转」	我相信00后将是没有童年的
这个真的是相当的有才。	怀念宫崎骏的动画片
很久以前……我在这里:alink	很久以前我只是个串店。就在我家对面
还记得你跟我说过的话吗：“爱你的人走不远。”你好好的。	“爱你的人走不远。”你好好的。莫名的感动
考上公务员了，副科级科员。今日报道，秀下单位。	还是科研单位呢，招人不？
篠田麻里子宣布毕业，峯岸南怒目而视	咪酱是伤心！别乱说
我还是觉得三轮车牛逼。特牛逼。	大悦城门口三轮车保有量超过50辆
饿了一天了快晕了！终于来到(老码头)，开始了！	貌似对嗓子不好吧。
【谷歌眼镜拍照样张】alink	效果一般么！手控还是声控啊
被蚊子快咬死了，下班	没蚊子一身轻啦啦啦。
据说这是当年最潮的鞋子。你还认得吗？记得的转发。	小时候学跳舞还穿过
一张图了解iPhone4S跟iPhone5的差别	我觉得5的电池有那么耐用
忍不住饥饿，煮点挂面吧	慈心大善也偶尔练练厨艺嘛
孩子，我感觉你的号码选的不是特别好。（转）	苦命的孩子，就怪你爸
厨房必备神器！创意改变生活！(转)	绝对不能让老婆买这些玩意奇怪的感觉…
不带发带打球的詹姆斯能发威嘛？！坐等。比分：80:82还落后2分	阿伦突了！反超两分我的妈呀！
2012年5月17日，期待《精品购物指南》非比寻常。	有啥特别，送礼物不？
得之坦然，失之淡然，顺其自然，争其必然。	安之若素，处之泰然。
这什么逻辑啊！教训我你也配？	矮油啦这些都是脑残疾麻痹给它脸还不要脸了
善待他人，就是待自己的最好方式。	用宽容慈悲的心迎接生活。
小时候，快乐是多么廉价的东西。	长大后，快乐是多么奢侈的渴望。
范思哲版兰博基尼Murcielago谁能躲得过的心动	没人躲得过的心动。
关于内裤，有个事情我一直觉得很奇怪……#驴小毛#	被屁崩的。哈哈哈哈哈哈哈哈哈哈哈哈哈哈哈哈。笑的不行了。
新疆伊犁美景。马上奔赴新疆伊犁，开拍新戏。伊犁，美吗？	伊犁是不是还有熏衣草呀！
林昭狱中书，一位奇女子最后的撒娇，朝着妈妈。	不能看，看一次难受几天。
卷福，这是按脸给的吗？	表情像抱了挺机关枪
人民夹道欢迎，热情挡不住啊！	当官做到这样，走到哪儿都需要一副厚脸皮才得行哟！
今天一直在移动中，没看成比赛。祝贺孔杰	希望李昌镐也能这样，嘿嘿。
大晚上还吃这么一大块蛋糕，这事儿也就我干得出来	要给我我也干得出来
终日奔波苦，一刻不得闲！	丽姐别太辛苦了，好好照顾自己哟，。
【2013-03-13】征婚广告都贴到新六电梯里面了。	很好奇那个下面的字条是谁撕的。不是你吧
奥巴马和普京的表情对比	当过间谍的就是牛逼
听说这两天发微博，很多人都看不到，是真的吗？	只是知道你挺久没发微博了
等我有了宝宝也给他这么穿！	不得不说真的太可爱了
都别互相骂了，看看这牛肉如何。	必须就着辣椒面花椒面的干碟子，你懂得起哇？
华为手机，挺大的，难掌握。	这。都挺大，华为这策划，犀利
今天我过节！但是不放假！	今天我放假！但是不过节！
全世界点击量最多的视频alink	当世界都这样充满爱时，社会还怕什么
气不和时少说话，有言必失；心不顺时莫做事，做事必败。	多言数穷，不若守中
《号外》杂志三十年套装。	经得起时间的考验。！
很高兴在杭州和""娃哈哈""董事长宗庆后分享背后的故事：｠｠	希望娃哈哈越做越强，越做越大！
每次看到朝鲜这样的图片，我就弱智的理解不了。	洗了三代的脑。正常现象
ThemeaningofLifeistogiveLifeaMeaning.生命的意义就是赋予生命意义。	Aslikedreamyourdreamifyouwant.
全场比赛结束，大连阿尔滨3:1北京国安。	喔买嘎…又输了咋的…
#郑在喝水#郑渊洁提醒你现在喝白水或茶水。	很有意义，一点都不无聊。说无聊的，是他还不明白喝水的重要性
听到什么歌，你会想起谁？alink	听遥远的他，想起遥远的她alink
火焰冰淇淋哦，想试试吗？	会不会烧到我啊？会不会烫到舌头？
你好，八月！希望这个月好过点！	希望八月过得轻松点快乐点，最近都要郁闷死了
我就是想调查一下，还有多少人记得卡内奇·古哈这个名字。	头像西多，低调路过。
厦门环岛路音乐广场，到处是一片祥和的气氛。	真美，啥时候的照片？
2013年2月18日黎明，布宜诺斯艾利斯Sheraton酒店，晴	祝师兄一路平安，吉祥如意！
想有很多书，还有个大沙发，就舒服了。	有点杂乱倒也舒适，gaga。
咱学校的校服校长我XX你个OO啊！(有图有真相）alink	和俺高中的校服好像。
作为一枚伟大的吃货必须知道的经验。	原来大家都这么疯狂啊。我再加一个，香蕉蘸醋吃，巨好吃
穿黑毛衣却没推开她这就是真爱了。	你不会捏死它吧，看见红指甲有点胆战心惊
竖着是“中国”，横着是“CHINA”。	最喜欢这种文字创意了
【怎么每月花一百元钱做投资？】关于投资，让人震惊的观点	作者就是一脑残，比别人还外行，估计是学生写的
真想看到北京的第一场雪啊！	恩，我看到了，哈哈瑞雪兆丰年，希望我今年高考顺利。
#程序员段子#某公司招聘程序员的广告图……	这是用了居中吧。应该按照代码格式来才对。
《音乐之声》四十多年，一个都没有少！	小时候最美好的荧屏记忆之一。
你看懂了么？看懂就转。	一颗大树下面，挂着啥玩意呀？
中日大战，看一次笑一次。	日军战斗力更强啊。
有高手把电影里的手枪给P掉了。好喜感啊！「转」	哈哈哈。全世界都和谐了的赶脚
今晚，老罗锤到你了没？	去掉个中文换个底纹就以为高端洋气了？
开会当判官甲。有五个同学竞逐一本新杂志的总编辑，谁上？	谁让你上你就让谁上呗
名单出来了。如我所料。没我。	名单里有我。猜到的人。
我后悔小时候没干这事。「转」	不怕风扇突然炸了吗？毕竟现在很多产品信不过啊
时代地产·2011长沙橘洲（国际）音乐节演出时间表	还好苏打崔健垫后，咱也可以看了。
有感于自行车被偷，好吧，让你偷……	让你开，哼！可素自个捏
哎，世态炎凉啊。为了一根鸡肉干，这么变脸节操何在。	四月杨柳青MO要吃鸡肉干
听说新加坡4月17日以后对中国免签，有人知道真相吗？	活跃赌场经济也不至于吧，如果你来请你吃大螃蟹！
就象真的能够怎么样一样。	就像真的能够怎么样一样。哈哈。
＂你哭得像个孩子。没事的，会好的。＂	其实，孩子哭的是什么样子？
哈勃岛---世界上唯一的粉红色沙滩，水清沙幼，真正的粉色沙砾！	好梦幻的沙滩，在哪里啊？
可爱风婚礼蛋糕，你喜欢吗？	我要在礼堂的每个角落摆一个不一样的
平安宵夜。算是自己的庆功宴吧。和海儿弟好好喝点酒。	呵呵···喝的够晚的··
谨以此献给所有人生命中最重要的那个男人。	暴漫煽起情来也吊炸天！
地球人已经无法阻止鲸鱼宝宝了……\(≧▽≦)/	没有人陪我发鲸鱼宝宝。
有人能把你变成一个种族主义者。	有人说怀疑会危及你自己
大卫·贝克汉姆（（DavidBeckham）——有多少人迷恋他？	第二张有点娘，还有不迷恋
#郑在晒晚餐#在哪儿吃的晚饭？晩饭可以清淡点儿。	在儿童读物里普及吃的常识和健康常识吧从娃娃抓起
超市实拍，今日北京部分菜价：大葱32.98元/斤。	小汤山的就是贵些，普通的没这么贵的。
近年来，网络上的一些励志哥，哪一个会让你抓狂？（转）	太励志了.我这种屌丝还是要好好赚钱吧
Threadless年度蛋糕制作大赛！超漂亮滴。	这色素，还能吃吗？失去了原来的价值
世界上没有“粉丝电影”这种东西。100多年了，只有电影	那玩意儿就是几个短片拼起来的视觉类商品
想买支手机，思考中！	张帝老师我支持你，想买就买呵呵！就想唱就唱一样呵呵
一共127页啊手好酸。我在:alink	点开大图，我真的笑喷了！
今天要背这么多书进京，估计会很累	来看我就看我呗，何必送礼呢？(*^__^*)嘻嘻……
在静谧湛蓝的远方，那里的故事有不一样的结局。（850x850）	希望我们的故事结局也能在远方开出灿烂的花
#香港印象#【香港的闪电】你见过吗？	拍的不错，希望自己是个能持闪电手中舞的人。
昨日入山中，梅花一树红。折来欲寄远，青山千万重。	很美，请问神通广大的网友，这种类型的画是用什么颜料画的呢？
我只想知道她是怎么放进去了，求高人指点！	应该是用醋泡软了再放进瓶中去的。
主人对不起，我把假的摔碎了……	好好表现，不然不给饭！
#微博运营交流群主题讨论会第十四期#【繁琐而细致的客服工作】	用户虐我千百遍，我待用户如初恋
小时候关灯睡觉前，会这样胡思乱想的童鞋举个手啊。	会一直想着有个东西在看着我
如果你玩过这个游戏，那么你已经老了。	双截龙。我也老么喜欢了，一般都是跟我弟弟一起玩
铮铮铁骨不如一击重拳，只是说自己铮铮铁骨，有甚鸟用？！	Paralysisbyanalysis，行动才会改变
很温馨的一张照片，刘炜和大郅……岁月啊	温馨〜似乎也有些伤感吧〜
【7月31日奥运第四天精彩赛事电视转播预告】	继续关注跳水，三天三金牌！
同样是奥运金牌，56年前的体操可简单多了	56年前的世界太美好了
图中有多少个正方形？数了12个以上的可以考虑来英特尔应聘了！	求解答，怎么数都是11个啊
我勒个去，没事你躲在那干嘛。演恐怖片啊！	你装作你隐身了啊。
有多少人知道当年998那波大牛市的真实原因？	基本面改变：汇改，QFII，股权分制。
妹纸，你鼻子没事吧？	鼻头没了就剩俩孔了
＂把生命的每一天当作最后一天来过，保持对生命的敏感。＂早安	JohnLenon，Imagine.Wekeepthedreamtilltheend.
12月17日【人民日报、经济日报、光明日报、解放军报】头版	这就是中国特色，很正常
有些话，开口伤人，沉默伤己。	更坑爹的是只说一半，既伤人又伤己。
＃呐喊体＃大家一起来傲娇，有些XX就是比其他XX更XX。	有些食物就是比其他食物更美味
想有女王范儿，其实很简单。「转」	只要用心，一切都OK！
夜凉坐小院，无喜亦无愁。吃茶说闲话，果子砸上头。	砸头上的幸好不是榴莲……
今天焦点访谈：断桥之问——钱江三桥	CCAV抓不住重点！动车之问何时播？
这些名字你都认识吗。？	哇，很好看，才晓得它们叫什么
会做饭的男人是最性感的男人。同意的举手！	作为一个男同胞。表示压力很大。这尼玛是秀肌肉啊。
#杭州美景#这样子的西湖秋色，你是不是不想离开秋天了？	上一年秋天团日活动，，，绕西湖骑车，，，
再不减肥，你也可能会是这样的。「转」	这个是哪个动画片的吗？
恩。大哥。简直是太豪爽了！	原来那时候就冠名了
翻到最后一页时，奇迹出现了。	两个小时了什么都没有啊
【《在床上誉满全国》作者：暖小团】alink	老师您真牛逼！老师您真给力！
当年川军很多人都带着死字旗出川，死后用来里尸	共军？国军？这一刻他们是“中国军人”。
2006年的最佳封面#经济学人#庆祝天宫一号成功发射。	中国人民的老朋友抢先一步了.
灰常喜欢这个小朋友的思路。（转）	有的老师确实很白痴哟
茅盾文学奖的这几本书，我到底看不看呢？真矛盾！	我觉得得中国奖的书基本上没好书……
【马莉画室】思想者肖像：贺卫方alink	首先神形皆不备，其次光很诡异，第三嘴唇很恐怖。
地产广告，里面的文案很值得看看。	文案不错，和花生房产有着异曲同工的感觉
看图吧！真想快点搞一件这身衣服…	对付我的第一想法也是这个
春天里，百花开。重瓣樱花。	小米的摄像头不给力曝光不够。
也门小姐选美前八强。您觉得几号佳丽最美？	6号！因为她笑的时候，眼睛很美！
运杆还是不运杆好呢？正在认真考虑中。	无法想象不运杆，那力量会大到谁家去。
这才是奥运跳水比赛的看点…完美动作…（转）	以后建议都带面罩比赛
【习近平访南非】3月26日，习近平夫妇访问南非，参加欢迎仪式。	南非总统及夫人好像保镖和保姆，保镖同志还在掏枪
刘翔真棒！这是什么样人生啊。	风静了，雨挺了，刘翔回来了！要火
【今晨看头版】之南方都市报	从美学观点，必须把花字改成赚字。
你厌恶自己的生活，然而有人在梦想着过你的生活。	生活就是如此。天天夜夜如此。何时能换的不是如此。
北京的PM今天降到300了，昨晚19点顶破500的。	北京的空气质量真心好！
大风天有什么不好，它起码让我这种胖子找到了活着的意义。	你那么so！你好意思讲！
从今天直接请假到国庆节不被老板骂，就靠这个了，你信不信？	呃呃呃呃呃呃呃呃呃呃呃呃呃呃呃呃呃呃恶死了
大家中秋快乐！很开心妈妈过来北京陪我过节:)超幸福！	中秋快乐，亲爱的。
时尚新潮的鞋带系法（2），让你的双脚更加个性。#小窍门#	是啊，总觉得系鞋带太单调了！
《我们课本上那些课文的作者，他们都自杀了》	记住他们吧，这比“***脊梁”之类高大、高尚得多。
#原来你是夜猫子#你在天猫买的第一件宝贝是________？	小说《草样年华》全集。
网络微小说：「争取活到领养老金」是哪位大作，请认领⋯	致所有需要上班挣钱的人
铃兰——看看有多少人会为图而转！	从来没亲眼见过，一直很喜欢的花
最痛的距离是你不在身边却在我的心里	不、我认为是、我在你身边、却不在你的心里。
图案小工具，家装必备神器啊。！	哪里有卖！？！？有其他小清新图案的吗？
摘下月亮送给你，晚安。	送你一个吧，不就是月亮嘛
你猜，我晚上要干嘛？	有这功能就不用买电视了，最好高清过段入手！
求助求助：取款机里取出假钞肿么办？	用原来的机器试试看还能不能存回去，不行就多试几台
#母亲节#祝福妈妈健康平安快乐	#母亲节#祝福妈妈健康平安快乐
今天早上全家一块做早餐，家中猫咪在旁辺画了一张速写。	喵。是位有胡子的小姐。
传苹果最快明年3月推出iPad5alink	想想也知道这消息肯定假信的人也太傻了吧
让你们见识一下，真正的，一口闷！	那哥们嗓子得多大呀，，，
温馨提示：1990年出生的妹纸们，你们已经进入晚婚年龄了。	不是吧…让我们88的怎么活
看起来很凶，其实我很温柔！	看起来也很可爱！
大老外在休息室抓到的老鼠	加油！继续努力！期待！
一不小心「称心如意」又拿了收视第一！称心如意团队真牛！	有湘姐在，不拿第一，情何以堪。
你们男人接吻的时候能管好自己的手么？	哈哈哈哈哈哈哈，太逗了，笑死我了！
孩子，你的愿望和梦想是什么？	他想用上干净的自来水
【女生的标准身材对照表】看看自己是不是真的是胖纸？	必须对自己苛刻！。169+106
住在海边好幸福呢。站在窗边就可以看到美景辣我在:alink	叶叶在外面要注意安全！。希望今天好运喔
春运开始抢票了，你紧张了吗？	抢个屁。就在家。为什么非得坐火车。坐飞机啊。
在你的世界里，有没有这样一座小房子？	陈sir你点睇今年高考语文作文》？
某公司销售员的岗位胜任力模型。值得参考，收！	年后为公司销售人员招聘提供数据。
#看图猜迷#猜两部今年最火的电影	我就看到了速度与激情6
简体字下的中国，到底丢了什么？	剥开内心，满是伤痕。
这样穿衣服，你学不会的……	得学学，省得早上迟到。
教你做完美烤土豆，想不想试试？（几分钟网）	晚上回家买几个土豆试试
为啥你们总说东方的主角是个无节操的人。	献给用生命娱乐了大众的博主
粉刷酱、油漆工神马的最性感了。	都买新房啦？啥时候办喜事啊？
好的设计vs.糟糕的设计	哪里可以买APPLETV盒子啊
好像错过了一轮本季最佳月光。	似的，昨天的月亮超漂漂，至少天津和北京的月亮不会差太多
这是我的家乡哈尔滨，我想家了。	这里也有很多人陪你哦
原来基友最早出现我们天朝，壮哉我大天朝！	没文化真恐怖乱说一通侮辱华夏
维系一段感情的，不是坦白，而是考虑到对方的感受，有所保留。	谁说躺在身边的就不是自己喜欢的呢？
又是一件卡卡米兰时期的队服	拿米兰22号队服的沾光啦啊
生活是一个不断发现自己以前是傻逼的过程。	那些天真的时光，我们怀念并叹息着
谢谢长春，谢谢东北的知音朋友们，晚安	就知道深夜福利多！
【#天天向上录制预告#】今日天天向上录制主题！Whatisapp？	我可以表示图标排序和我基本一样么
明天回广州了，哈哈哈，三弟给大家弹一首	09年的照片都让你给翻出来了，犀利！
一想到明天是周一，头就疼得厉害。	是有点头疼，不说别的就说塞车吧，，，，，，
这是我三岁半的宝贝儿.可爱么？	猫姓啥？国籍是哪？
如何赢过自己的私心和愚蠢恐怕是最难的比赛#一个人的奥林匹克#	你还是和以前一样美丽和睿智，喜欢你。
2010年9月，希腊，雅典，宪法广场。唐师曾摄	应该比国内好得多吧……
视频发布日期是2010年12月16日。	这个也太不靠谱了吧。
#看图猜电影#这是哪部电影？	这条汉子这个是毕业了吗
原来古代女侠都是这样避孕的alink	这么厉害这个剧是仙鹤神针？
这是所有iPhone5恶搞图之中的冠军！（图/我爱科比网）	小四，你终于有出头之日了
不求海天日月般的永恒，只为那一瞬间绽放的夺目	这个指甲油颜色够艳够漂亮
小猫咪做恶梦，猫猫妈妈就安慰它，真的太太太太太有爱了！	这小猫太可爱了，萌死了
我睡着啦啦啦啦……哈哈哈那是假的	我睡着啦啦啦啦……
俺以前的驾照，不知道现在还能用不？	你在哪考的？我刚报名，教练说用辽宁号练。
【买手机送宝马】节操掉了一地alink	那是一张图片，尼玛我点了n下，还以为chrome又崩溃了
哥的气质你们是学不来的……	围巾跟它的毛真配！
比赛回来了，赢了！很累！自己要用实力说话，剩下的人。嘘。	你们要好好保重哦。到最后真怕你们不够人上场了。加油加油。
马里奥哭了，以后再也不跳关了！alink	我看了，我也哭了，玩了那么久小霸王，才知道有传送之哨
各位秋天好，最近有多少人打着贴秋膘的旗号在胡吃海塞	各种肥的糕点做起来
当年觉得潮爆了的，现在有木有真心觉得土爆了。	哎哟喂。立马石化了。
我爱死这个日志了。	完了我，第8条碉堡了
苏州风味糯米绿豆汤，听说还有很多人没见过，感受下。	救命不是隔夜米饭啊，是糯米！没吃过别瞎黑好吗
看完我不知道范冰冰是谁了。	太牛逼的某冰冰们了。
绿玫瑰，据说转发后会有好运。（转）	希望明天给我带来好运，叫我赶紧过了。
送上一张华为#U8800#美图，祝大家五一快乐	啥时候才能出2.3的固件啊？
为什么妖精们，都有机会，但最后都没吃到唐僧肉？	其实退而求其次更好，吃了八戒的肉也可以长生不老滴
我们都搭上了这台停不下来的列车……	不要停啊，婵姐，今晚呢集好好睇窝
治愈系喵咪合集，45度角的仰望。（转）	最后那个无比自豪，回家去拍臭臭版的45度角
【分享图片】朝鲜V美国。我被这张萌到了。	朝鲜小朋友超萌，超可爱！但也不得不承认“小鬼难缠”啊^
2012年，父母健康是儿女的最大心愿，这个必须转！	父母身体健康是儿女的最大心愿
【Jeep创意平面】捕捉荒野。	不知道他的卖点在哪
天山雪莲，没见过的童鞋转转。（转）	怎么那么像假花，有懂的人吗？
啃西兰花的小仓鼠，好萌哦。	你妹！我儿纸就从来没在我手上安分过！。
你能不能站在那儿不动让我追，你走太大步了π.π	看你的微博，我无法自拔了，深陷你的世界中
这妹纸你就是我偶像，动作难度系数9.99啊。鉴定完毕。	就是不掉下来怎么地！
我从未让他们骄傲他们却待我如宝----致爸妈。「转」	给自己攒点骨气吧，犯贱的过去就过去了，未来才刚开始。
逛贴吧被这个签名闪瞎了。/转	尼玛又一个不甘心自己瞎的
MWP，还是改回本名吧	现在你不拍电影了吗？期待你的影片
西瓜+空调+睡觉+电脑+手机+WIFI+冷饮+一个爱你的人=一整个夏天。	除了爱人，一切就完美了
【看不见的武大•风景】	武大啊。可惜进不去。
金正恩视察朝鲜人民军的伙食——【没有肉，全是主食？】	长的白白胖胖而且看上去又有点呆，怎么都不像块从政的料
要是没有个慢性咽炎，你都不好意思被人叫“老湿”	老湿，对于微博开始淘宝店推荐你怎么看？
传说中的神马！弱弱的问一句：是林肯牌的么？	估计是林肯加长。显然的咧。
年年春深时，离乡总生愁。墙头花正好，一步三回头。	年少轻离别恨不三千里鬓已星星也僧庐醉听雨
向XX同志学习，XX同志一定是牺牲了的。前苏联总是这样。	是否小崔预感自己将不久于人世？全体崔迷注意了？有情况！
开开眼吧。放海带的绿豆汤。	我们那里也是啊，两广都一样！
载歌载舞的干部，员工，体现了企业的文化与精神。	体现文化、得发奖金。
沉默不代表恐怖；但是，恐怖却往往从沉默开始。	有时候沉默不一定是金
少数服从多数，真不代表错误服从正确。	小萌姐，你不主持央视了么？好久没有看到你了……
如果你能看懂这个表格，默默转发。	确定是米开朗基罗不是多纳泰罗？
2012年欧洲杯完全赛程，准备好过这个夏天……喜欢的朋友收藏吧。	现在开始补觉吧，今年夏天有的看了，欧洲杯加奥运会
对于米歇尔不见彭丽媛的十点意见。——解滨	哇塞高级黑啊说你是谁派来的卧底？
遇到这种好人我是该笑还是哭QAQ（转）	钉得这么好？塑料外壳不会破裂？
悄悄的告诉你：上图是日本老毕。	神图。一大早八卦这个，会不会对不起上神啊？
韦德生涯最血腥扣篮之一。	就应该补个詹姆斯的表情
#看图猜电影#这三部电影分别叫什么名字？	中间那个是变形金刚？
韦德扣篮破荒，身带两次犯规，要小心啊，第一节还没打完	这样状态打下去，必跪。不认真。
巴萨训练的抢球游戏，我震惊了。	没看明白牛B的地方在哪里
春天来了，你困吗？	富有需要大力宣传，而贫穷则需要善意发现.
儿时用这个玩过恶作剧的，请转发！	l玩的！丢的身上都是！
奇虎股价昨晚大涨8.4%，创历史新高，市值达44.5亿美金了	奇虎真的值这么多吗？
假如翻拍≪罗马假日≫，你觉得谁可以做男女主角？	哈哈，还记得有个杂志说杨幂像她骗粉来着，结果评论都是像个屁
叫我女王大人。好的大王。没问题大王。	大王叫我来巡山#chunwan#
我们最先衰老的从来不是容貌，而是那份不顾一切的闯劲。	真的，我怕失去它
如果三国有了微博。笑死了哈哈哈。不得不转啊。	诸葛的爱过亮瞎了！
吃完西瓜再来一壶水！七饭去咯。	又吃瓜又喝水，还有肚子吃饭么？呵呵，晚安飞！
爱上一座城，大抵是因为，这里住着一个你爱的人。	离开那座城，也是因为有那么一个人吧
日本超萌火车。旭山动物园号！	好有创意，好有趣哦！
这个小狗，当时基本是家家都有！有木有啊！	这个还真的有！现在都还在，一直以为是狮子呢-_-'
北京西郊，江青最后归宿。	诸城宫墙柳，潍河边岸杨。随风西行去，空余海上殇。
喵星人居然不怕水！一定是我的打开方式有问题！「转」	这只猫还跑回水里，哈哈哈
【被踩头的延安单车行老板：道歉信不是我写的】alink	垃圾、愚昧、张狂、黑恶的地方政府演绎吐血的剧情。
东方之珠，我的爱人。我在#太平山顶#alink	我总觉得从太平山顶看下去，东方之珠有种地狱之花的感觉。
一边做饭，一边开枪，主席夫人金正淑同志是不可多得的女英雄。	一边做饭，一边放炮，真豪姐
明天去南京，录一档很好玩的节目。	非诚勿扰？非常了得？一站到底？芝麻开门？跳水？
你相信这是卫生纸卷筒吗？作者太强悍了吧！	确实强悍！。闲情逸致的的高境界啊。！。
金正日什么的都弱爆了，普京人类还能阻止你吗？	我感觉中国的都做不到呐？
广西玉林狗肉节震惊日本社会：要杀1万条狗啊，太残忍！	吃鲸鱼的装毛线这么说
儿时用这个玩过恶作剧的请吭声！	我上次摘得太急了。还弄破了手呢很好玩的
白胡子美髯公。话说这流着口水翻着白眼哪里美了。	纵然千滴湿前襟，吾爱毛之唯心。
人世忒不清静，名利惹人心烦。何时收拾行李，独自遁入秋山。	归去，也无风雨也无晴！
黑云压城城欲摧？谁能够担当救市重任？唯看金融地产。	地产还能救？要这样说的话，那我对股市还是没信心！
最佳男女身高搭配表。「转」	差15CM话说男淫身高需要精确到小数点后三位么
沙宝亮和杨宗玮的唱功差距有十个黄贯中	我觉得差20个，呵呵。
【电脑操】每次两分钟，电脑病痛去无踪！很实用哦。	必须收藏，最近周身酸痛
嘛都不可怕，就怕非洲人民听得懂中国话…	13亿中国人等待一个黑人朋友来主持公道，悲哀！
嵌入的半圆形床，大大的窗户，温暖舒适。稀饭滴同学举手！	啊咧。看起来好好玩。
期末了，求及格。见此微薄转发者期末肯定不挂科。	下周考试啊，完全看不进去书啊
【轻松一刻】兔牙可不光是用来吃草的。	可爱的兔兔，这牙可是真厉害！
有过这样班主任的同学请默默转发。	貌似每一位都是这个样子滴……
换了一个紫色的固定，和超搞笑的医生合影	唉…，你那边是白天吧，照顾好自己；
昨天巴萨全队在一家酒店聚餐，庆祝夺冠。图集：alink	蒂亚戈和他麻麻一起去的？
为了解决抄作业的不好习惯，高数老师这回要逆天了	庆幸我的老师没这么变态
买这个杯子是打算喝咖啡用的结果第一杯喝的是感冒冲剂	是同仁堂的无糖型吗？那个比较好用
喜欢这四个字的同学，请默默转发。	遇到对的人，怎么都是对
这年头当爹不容易啊。（转）	好爸爸和幸福的女儿
好吧，大概是这个原因吧，反正我信了。	好吧。不管怎么样我也信了
北京空气，到十一点时继续“危险”，并且继续恶化。	当新鲜的空气成为奢侈品之后。
史上最萌河南坠子！	这是说的哪一出啊？
据说在网上卖疯了，男用贞操带金属CB3000全钢版带锁|防手淫|防勃起	30天12件你也喊卖疯了。中国人好少哦。
生如夏花之灿烂，死如秋叶之静美。一张图所展示出的四季！	生如夏花之灿烂，死如秋叶之静美。
当学习工作烦躁时看看他。就激情四射了！	果断转发，好可爱啊…………
左边？右边？哪种是你的style？	体验而言，肯定左边
南方都市报头版头条：治疗H7N9新药获批上市。广药	关广药屁事啊，据说是军队内部产的
【当十二星座被讨厌之后】天蝎座，果然狠。	感觉天蝎座也不是很准吖
震惊了，在日本开火车，真是个技术活！	就因为你这条微薄，我决定取消关注了。
1957年的北京，摄影：马克·吕布(MarcRiboud)	1957，北京。都好有范儿！
#WWDC2012#NewiPad牛排也加入了Siri支持。	我的牛排总算有点意思了…
黄昏过余杭，微雨话秋凉。桐乡且小住，坐等菊花黄。	最喜这篇，余杭、桐乡，听着亲切。
据说每个人一生中，都会遇到一位叫“吴迪”的人……	是啊小学同学就叫吴迪。
中国女篮加油！吃掉泡菜！拿奥运门票！没理由输的！	有问题就直接问你？真的回我吗？你原来能扣篮吗
今天我过节！但是不放假！	哈哈！节日快乐！爱你哈！
富人相亲的资本论(女版，男版)……	这种新闻，现在真的见怪不怪了，看一看，笑一笑，就这样了.
玩的不是羽毛球，是寂寞。必须开挂了。	擦、你说这不是开挂这是肿么了
西班牙海鲜饭！奔腾的食欲哇。	我表示：我饿了。！
这狗狗都成精了尼玛！喵星人表示很无辜	哈哈哈，让小猫替背黑锅。
这是我的精神粮食。如果没有你日子怎么过。	可以放在我这里，哈林哥我帮你保存。
每天告诉自己一次：我真的很不错。	每天告诉自己一次：我真的很不错
一个能感动数亿父亲母亲的瞬间。	宝宝的头不是应该朝下的吗！
★【用牙签拼成的艺术品】：用牙签拼成的精美艺术品，超赞！	这不是牙签，这是蜘蛛网啊
小学读的是这个版本教科书的童鞋请转发！感觉太亲切啦。	好吧收藏起来吧图图
别沮丧，生活就像心电图，一帆风顺就证明你挂了。	其实挺美的，挺美好的
看到2只以上老虎的转发，今年必将虎虎生威！鸿运当头！	一眼就看出来了，今年太背，快转快转
夜色星空，如此绚烂，来自日本摄影师宫坂雅博的作品（1449x2000）	遥不可及的彼方，是神的领域吗。
英国最美小城巴斯的罗马古浴场。	旁边要是站过美女老太太就。
求大神帮照片上P两个帅哥	哈哈····超级搞笑的微博
一个月总有那么几天，想无理取闹。烦躁。！（转）	哈哈哈好可爱的家伙^_^
长安街，有一群美女裸奔。	哈哈哈哈，好多美女在裸奔哪
蓝精灵们为什么会出不来呢？小时候我也很疑惑！骗小孩吗？	蓝精灵都是实在的孩子们。
人生六台车，你坐到哪了？	第一架应该系白车或者系担架车
左小祖咒名片设计，莫打，号码假的。	太有才了，你丫就是爱把人带沟里。
喜欢你的人很多，不缺我一个；我喜欢的人很少，除你就没了。	我喜欢的人很少，除你就没了。
目前，有10多人受伤。暂未接到死亡报告。	以后坐地铁不要站在连接处，谨记谨记！
一个囧萌的蛋糕被吃掉的全过程（笑）	hahaha奶油怎么这么多！？
唯品会大火之后，当当推出了“尾品汇”，真逗	开心网大火之后，千橡推出了“开心网”，更逗
新的一天开始了，天高云淡，阳光明媚，好天气，好心情！	rober不会每人奖一套K3吧！
依次关闭300个页面做出一副动画。很温暖的日本广告。alink	有令人感动噶感觉。一大邦人合力做好一件事的感觉真好。
【IT搞笑】不会电脑的人伤不起啊！（转自网络）	第五个赞。现在似乎真可以用来做杯托了
我们应该把男单转完，还是该进CBA呢？	网球都看央视呢，北京的解说没法看
周末在NapaBBQ，看起来很美味。	欢迎回来steve，关注互联网创业的同学们看过来！
新赛季CBA夺冠赔率，各位元芳，你们怎么看？	江苏今年三外援估计也跌不出后三啊
成为月薪两万白领必须精通的10款软件	已经会一两个了，我要涨工资
★画的人和被画的人都不容易。	何必呢？艺术吗？噱头哎！
我在江西移动网管中心：值班呀值班。alink	握爪。我也在值班呀值班
【著名公司logo演化史】看起来，极致简约是主流。.	公司logo也要与时俱进！哪怕是神一样的APPLE公司logo！
女作家把＂偶的爹＂照片po出了，真爱无敌，哪管其他。	据说已经离婚了。一为炒作自己。二为。你懂的。
这样滴地铁入口够震惊？好喜欢。	不在中国，中国人就有心也没这胆！受不了大众舆论。
#时光机#在哪里会不会有一扇门，推开就能看到那时的你。	真的好感动，看到这个系列。
“你又胖了！”正在狂吃的吃货，听到这句话后往往是这个表情！	我已经很尽力减肥了。
#热火vs马刺总决赛对决#9：07，热火20比27，第二节还没有得分！	詹姆斯别犹豫啊越犹豫也不中
以青城近日的温度，怕是要穿秋裤了吧。元芳，你怎么看？	大人以您的身形少穿几件也无妨
好锋利的刀！就是这么霸气	将路灯一劈为二，霸气十足！
心存善念，便会途遇天使。	心念慈念，便会途遇『天使』
政治僵尸申.纪兰早年照片。	是哪部电影的海报？吃惊]
如果生活如照片般美好	热爱生活，每天都要快乐哦。
今天上午休息！好久没有睡得那么香了！	听你这么说好高兴，希望小叶子每天都能睡好
我客观地说，上海的麦当劳比北京的好吃。	虹桥的85℃味道也倍儿棒。
在世如莲，净心素雅，不污不垢，淡看浮华。	在世如莲，净心素雅，不污不垢，淡看浮华。
居然是用书雕成的。	想证明书中自有黄金屋么，怎么不雕个美人出来呢。
还是那句话，千万不要让老爸带孩子。	哈哈哈哈我决定不再抱怨我老公
【那些年，他曾流过的泪。】	服装4分，演技8分，表情7分，感情负分。综合打分：-10分。滚粗
清八大山人《柳条八哥图》	乡野之间，自得其乐，清高傲世。
关于同性恋，有一本德国的儿童书里是这样教的。.（转）	好棒的教科书，从小了解认识才能在长大的将来正确对待。😊
屌丝，过来我给你看个好玩的！	小马：老马来看，我摇出个美女。老马：呵呵
人类失去信仰，世界将会怎样？	人类信仰是什么呢哥哥
哈哈、主人我给你捡回来了！主人我给你捡回来了！>转<	燃放烟花注意行人安全。注意有狗。
世界在变大，还是只是我变小了？	世界在变大，还是只是我变小了？很有创意
#晚安#老天在送你一个大礼物时，都会用重重困难做包装。	嗯。所以始终相信。三年。该我来疯狂了。
曾经有过这样班主任的童鞋们请高调转发。	我们老师都是直接进来坐着听的！
发现一颗精子翱翔在蓝天上。	上帝在找玛利亚，赖宝快上。
甘肃省政协委员彭丹下乡体察民情。	做什么秀。把人都丢尽了，
海怪。属于古生物，万年前	记得09年在石家庄出差的时候见到过，一直不知道怎么吃。
又到了满街黑丝的季节了……不过看看这些，穿出去绝对成焦点！	性工作者的工作牌。
不知道自己穿行在哪里，只知道自己的心，留在了北京。	穿行在重庆，可心真的留在北京了…
整理出一堆文革史料，再公布几份，请欣赏！	说你家是何许人也？
大概25岁以上的人都有一本这个。	小诗哥，夏目是你什么人？
今天追高的，都将成为炮灰。根基不牢，墙要倒。	你要当反指怎么说？
这还能再苦逼点么！尼玛你招的这是超人吧！	现在很多小城市、小公司都还是这就价呢
开福寺，八吉祥。长沙，女性频道，活色生香，拍摄ing。	大师阿弥陀佛-----祝录影顺利
这个乘法口诀牛X大了。留着教孩子吧！	给跪了………………
中国的每个省都是个美女。「作者不详、快乐麻花」	能不能画出福建的呀
你剪掉了我的翅膀，却怪我不会飞翔。	你给了我飞翔的翅膀，却怪我飞的太远，不回家乡
每回用空调我都会担心它会不会突然爆炸微波炉同理	不会我觉得微波炉才会
这预览图也太丧心病狂了……	剥夺猜测犯人的乐趣，实在是种高级趣味。
往机场的路上随手拍的，有没有人觉得它像。	这个照片的日子刚好是我生日那天哎
分享图片等不打球了就改行干这个	哈哈哈哈。这么快考虑转型啦？
调查一下，大家是什么时候知道风油精可以喝的？	调查一下，有多少人不知道风油精是可以喝的？
为什么我的微博首页只能看到这个？	一会儿好，一会儿就变这样。
今天下午，锤子科技的窗外。	老罗，不会写代码的帅哥要不？
微博，会把每一个官员都慢慢地带上良民的轨道。	首先得把一部分官员带到大牢，而后才是良民的轨道！
长谷川润已怀孕五个月，祝福！	好美！五个月还是这么美
有时候，一个人就是你的全世界。——图与文无关	日敢不敢不要丑搞！
这结婚照拍的，羡慕嫉妒恨啊啊啊啊。	我也想拍。谁来陪我拍.
请相信：无论快乐，抑或忧伤，都不会持续得太久。	骆老师，人生的意义是不是就在于这反反复复的快乐和悲伤中？
今天地铁上碰到个没素质的，发现怎么应付这不讲理的还要磨练	通情达理伤身体，画个圈圈诅咒他。
抵达扬州！祈福雅安！明天开跑！	明天的比赛你不解说嘛
【元宵晚会现场图片3】廖昌永、蔡明演唱《因为爱情》。	好歌被他俩给糟蹋了！
关于吃完奥利奥拉黑色大便……暴强回复！看到第六条，我喷了。	ohno，讨论那么恶心的问题
等咱有了钱就买一座岛，再盖个大别墅。	niceshoot！在哪里照的呢？
会化妆的男生你伤不起……	我的天啊，的确伤不起！
【10佳iPad底座】图中有你喜欢的吗？	喜欢最后那个。！环保！
【厦门BRT爆炸起火案嫌疑人陈水总的自白】是谁培养了恐怖分子？	：当官一张嘴，草民跑断腿，他算跑得少的了，这个邪恶的党。
不乱于心，不困于情。不畏将来，不念过往。如此，安好。	一个人活在世上又怎么做到这些看似简单的几个词呢
真的问问大家，你们想看到什么样的体育新闻？	NBA啊现在nba才是王道
这就是我想要的生活	这就是我想要的生活
我爱你因为我喜欢我执迷不悔的样子。	执迷不悔的境界也不是谁都能有的，有过这种样子挺好，挺迷人。
被这个妹纸的表白方式秒杀了。	谁有这妹子牛逼，哈哈
哈哈，在虎扑上看到了，拉莫斯的那个笑死我了。	拉莫斯最后那个笑喷了。
再严重的水灾也不能影响生意。	应该是再严重的水灾也不能不要发型
成功无捷径，惟有不放弃。	成功无捷径，惟有不放弃。
悟空、你的筋斗云呢？！	悟空改交通工具了！
你坐飞机有几次是按机票上的时间正点起飞的？	从来木有，国航尤甚！
【治愈系图片】又到了毕业季——这么有爱的毕业照你们见过吗？	第一排左边第一个是谁，就他不认识
这张图才是绝对的治愈系！	所谓庸人自扰，真正看透，这叫看透。这是层次。
男士泳衣，这是要火的节奏啊！（转）	这个东西也只有硬了以后才能穿上吧？
介个真的只是盆景吗？美得有点过分了。	真的好美，好有爱的说。
这哥们几乎没有不会的项目，他就是我的男神——普京。	就算做不了普京，也要吃的了蒲挞
好可怜的狗狗，没把主银咬死，就是真爱。「转」	没咬死你说明他爱你。
曾几何时，我们已经习惯了不该习惯的习惯。	曾几何时，我们已经习惯了不该习惯的习惯。
两岁宝宝的性感热舞，这也太有才了……。alink	突然好想让我女儿也学学。
终于有空可以陪妈妈一起吃饭了，真开心。	名星真的那么忙啊！算了，以后我也不出名吧！
今天有人过生日，餐厅准备的蛋糕看上去有点面熟。	今天有哪些江湖侠客来贺寿了？
痛批社科院：“房价全面失控”论，纯属胡扯！	危言耸听，找台阶呢。
#漫画欣赏#困惑的主人困惑的驴。	有时候需要""justdoit""的精神.
有惊喜在理面只有一位幸运儿alink	好可爱啊。艺人很辛苦啊。
天天第一次来我家这么安静，我跟她说，画完一本儿才能吃饭。	你就是不给娃吃饭是不
一个人在家宅久了，就神经病了这只猫抽风了！	爱马，这小风抽的，可爱属了。
两情若在久长时，咱会上见。	天朝两会最佳摄影奖
记住，这个季节对你不离不弃的只有蚊子。	最讨厌蚊子拉😱😱
你有多少年，没见过自己打伞的天朝领导人了？	多做运动身体更健康！
2012年想求财的朋友马上转！金龙降喜，金龙保佑！	金龙降喜，金龙保佑！
动物三件事情，吃饭交配睡觉。人类比较麻烦，多了一项胡闹。	人类貌似吃饭和睡觉也是为了交配，胡闹，胡闹
刘翔:我还会回来的！栏还在那里我还要跨过去alink	放弃有时候需要更大勇气
那就是。。。青。藏。高。嗷。嗷。嗷。原。。。	死，，了都要，，爱，，爱。爱。
当你要开口说话时，你所说的话必须比你的沉默更有价值才行。	有时候沉默比发言更有力量！
这是让全场两百多人一起跳舞的花旦，也是今年的获选机构	看啊每人诚心的微笑不知道世界上有什么比这更重要
max完全改变风格，留起胡子，走硬汉路线	留胡子不是艺术家风格么
朋友们早上好，今天的空气质量。	推开窗子目测+鼻测了一下，美国人今天不准；仔细一看，22日的！
这样的LED灯，见过么（动图）	帅气，求教程做一个
喂喂，尊重亡者也要尊重这只好么，记者配图有点操守。	…………………………三叔……
看小米盒子，也是一种享受。	上班也是一种享受，
小时候的你是否也很喜欢和妈妈一起睡，祝天下的母亲身体健康。	非常喜欢，长大了也喜欢
上一次看到满天星辰是什么时候？✨	已经不记得了，或许是童年，或许是梦中。
马刺94-82客场击败勇士，4-2晋级西部决赛。	灰熊止于马刺，马刺加油！
调控10年房价为何涨10倍？alink	谁叫你相信政府的！
门口的酒吧还真是真理啊。	再加一句“Don'tdrink”然后就没人进去了
据说，人的一生只能吃9吨食物，谁先吃完谁先走。	9吨的话我早死了「吃货」
约翰·列侬和小野洋子，摄于1968年。（组照）	平静对待生活的两个人，才有可能将每一步都走得完整。
因为……真的很可爱嘛！	我就是这样的，难道因为是巨蟹座的关系？
妹子，放弃吧，打枪是男人的专利。	这句话，额，带有歧意
现在的我……上不去的是工资……下不去的是体重。（转）	现在的我。上不去的是成绩。下不来的是体重。
最疼我的男人我真的很爱你。	从小就唱世上只有爸爸好！😘😘😘
one-hitwonder只唱红过一首歌的歌手。你想到谁？	还能有谁。我用尽一生一世来将你供养
祝大家蛇年快乐乐乐乐……天冷别忘穿秋裤哦！	一定不会忘的！穿着秋裤看湖北卫视。
各位早中晚好，应该有人已经要在车里开暖风了吧	没有，我来的车是敞篷绿电电动车！
还有六天给大家温习，8月6日来小巨蛋要和我一起大合唱喔！	看看人家台湾的票价VIP才4800台币
临睡前问一句，你说老卡临走是不是特后悔放弃了核武器？	所以说，独裁者是整个地球的灾难。
杨钰莹的声音我只能坚持五分钟，你们呢？	楼下你们都在说什么呢？
你不可错过的「彭博商业周刊」中文版创刊号。	我昨天买了，支持donglu老师！
今日冬至，阴极之至，阳气始生，天干物燥，谨防上火。	滋阴补阳。要买点梨吃。
很晚了，睡了，每天早晨叫醒我的绝不是闹钟而是梦想！	叫醒我的，有老妈，有闹钟，更有梦想，还有习惯。
抄作业不怀疑对方做得对错是抄作业的基本道德。「转」	多拿几份一起抄比较保险也不易被老师发现
夏普首款Android手机5英寸SH-10B	我更喜欢下面那个索爱(喂==)
火罐拔完之后，女儿的杰作！（转）	好家伙，这种笔弄身上可不好洗了，孩儿他妈一会有的干了。
深度分析李雷和韩梅梅为何没能在一起！「转」	Kangkang、Michael、Jane、Maria才是我们那时代的
今天是黄家驹生日！请用一句歌词来证明Beyond是你的最爱。	beyond！家驹生日快乐
#GIF#你们先走，等我再飞会儿。	有木有想开网店的？
#早安微话题#你希望以什么样的方式离世？	为自己心爱的人死去。
进击的皮卡丘！表情好评！	看我配词！“死蚊子！叫你丫的咬我！看你往哪跑！”
冷吧冷吧，把那些没有脂肪的瘦子都冻死吧！	好吧，事实证明我周围的瘦子都很抗冷，只有我这个胖子在打哆嗦
#团团分享#周杰伦是三年二班，菇凉，你曾经是几班的呢？	不出意外滴糊话我明年的班级。
生命是一场遇见，人来人往，最稀罕的就是遇见另一个自己。	最稀罕，但总会有人遗憾。
有时候，我们不要想太多，顺着自己的心意就好了。	总是这样想但做时总不是这样做
非洲龙血树，看起来像极了一个个胎盘和脐带	上面是基蜕膜跟丛密绒毛丛，下面是脐带
【治愈系图片】关于结婚照，不能太做作，一切要很自然。	不管是什么照片都喜欢这样的感觉，谢谢！
#生活大爆炸#穿越了，原来这些天才真的存在。	。历史上有PENNY这个人嘛。丰富了天才们的课外生活
海底捞外送服务！享受过的童鞋请举手！	真的啊？这么好，这个不错！
胜利属于张靓颖！属于超女！属于国际范儿！	嘉宾还就张靓颖震住了
来说说你最爱的三样东北美食，不许贪心，只能说三样哦。	最爱吃酸菜猪肉炖粉条子，然后麻辣拌，然后一锅出。
收拾了一上午，终于差不多了。以后再买书，一定只要电子版	这是干嘛，为什么打包？搬家？
突然觉得真是这样……（转TX）	这个暂时还木有.咱班全是女生啊.我那个悲催。
这半年以来你看过的最差劲的电影是___________。	太多了因为太差劲都不记得名字
今天伦敦-4度来自香港的冷到想哭！	人民战士。几时再打比赛啊？
你的童年，有没有这么个东西？怀念吗？	虽然很油！但还是觉得很好吃1.5一个！
早！今天话题：什么东西别人有，而你没有。	过分啊，好身材别人有，我没有啊。
#健康小常识#绝对绝对绝对不要在临睡前看《将太的寿司》	小图超级恶心的好么
母亲还在说。江河在流淌！	就是社科院的于研究员？好人啊
2013年维也纳爱乐乐团新年音乐会图片第2波，分享自维也纳爱乐乐团	他还是那么精神-w-！
昨天晚上做梦我回西安翻译学院了，还住进了南一。	校友校友…啊…我居然有这么牛的校友…
小姚2013上半年段子合集来啦，太好笑啦！	造窑那个太好玩啦，哈哈哈
澳洲四大最美薰衣草农场——震撼的紫色美！	好美哦，想做成画挂起来，像素够不够
小时代中各种类型的男人里，你最稀饭哪一款的？（转）	我宫先生······真是帅嗷嗷嗷啊奥
奢侈品与公款消费联系如此紧密？	都成兵马俑了，还能发声？
害怕困难时，试试这个。太励志了！「转」	年轻放弃一次又如何
会化妆的男生你伤不起……	这是门技术啊！得加强学习！明儿哥也倒饬成一正太。
在我孔二狗这个名字前面加个scc，能多点粉丝吗？	可硬件不行啊，用永久自行车车震嘛
据说是阿哈尔捷金马，也就是汉朝的汗血宝马，身材真好。	这身材太棒了，毛色光润，体型健硕，真漂亮！
米国海军学院我在#USNAVALACADEMY#alink	啊？啊？使徒子难道不是纯爷们？
据说这张图，很多处男都看哭了（图：网络）	这个有卖吗，我要送给前男友。
给人以宁静，予己以清幽；给人以宽松，予己以从容。	宁静、清幽、宽松、从容
我们不照搬西方模式，只看标题就知道了。	浮躁这个词具有主观色彩国情这个词从来就是一把伞
给我好吃的嘛！不给我，不给我我就卖萌啦啦啦啦。	耍赖也不给你吃，哈哈
这就叫：本是同根生，相煎何太急！	喝奶茶的是曹丕的后代
一无所知的世界，走下去，才有惊喜。🌻早安	是真的吗会不会走下去更加迷茫
很多成功的民营企业，都有一个暗恋着董事长的女副总。	董事长是女的怎么办
婚车不一定要多豪华，但一定要有特色。（转）	遮挡车牌12分没有了。
【棋术牌技】象棋残局求解：红棋先走，怎么走？	炮二退一，对方炮4退六，然后车二平七。
司机是怎么从车上下来的呢？	他在里面生活根本不用下车
腾讯(Tencent)2013校园招聘正式启动，查看并立即申请：alink	人家网站做的真漂亮呀。
今天看到最励志的一句话：离过年只有99天了…	三个月.唉.我还没平帐呢.
孩纸，你给人类丢脸了。	我小的时候也像这样被追赶过
eicodesign新的洗手间标识，大家能猜到是什么意思么？	一朵鲜花插在牛粪上。
中国最受欢迎的人叫全票，他总是能当选。	反对票在选举之前已经肃清了。这叫保证革命队伍的纯洁性！
绽放到最后一刻色彩还是如此高贵。所谓国色天香是也。	陈SIR，你系影帝啊！影得好好睇。
楞装纯情小少女啊哈哈哈	磨皮磨过头了！要不要这样a🙈🙈😱
当憨豆和NBA球员结合。最后邓肯无缝对接。「转」	……石佛，名不虚传！
说好的ipad代替一切呢。	说好的ipad代替一切，笑死我了
谁能搞到chinajoy的票呀？我要去和showgirl们谈谈心	我也想要。给我再搞张呗呵呵
将此图献给星期五晚上还要留下来加班的童鞋！	到底多深，真想知道
2013年东京布道——远志明牧师讲道之一alink	视频被删除了，哪里还有？
这PS也太强悍了，你都看到哪些明星了？求正确答案。	太有意韵了，我想说我还看到了""华仔""的影子！
每一个超越昨天的人都是人生的赢家。（BY佚名）早安，各位。	🍵🍵早安，朋友们
熊市啊，中午来碗菜泡饭算了。	还别说，这一口很对味，我也经常如此打发。
哈哈哈哈哈右边都是历史帝！	这么熟悉历史电视剧啊！。
看图识字讲故事。区区一个政协委员四年洗钱十二亿欧元。	这人是私人企业集团老总，政协委员不是政府官员
唐朝贞观年间的古银杏树与九零后的大佛。佛大山灵。	老师你照片照的真不错。！有时间来青岛玩玩吧。
北京美味小吃合集！没吃过的果断收藏吧！	果断收藏，我要搜罗全国各地的美食
怀念糖人的味道，怀念这种情景，带着一丝不舍，我们都长大了。	想念古老的北京城，想家。
#Tango无厘头一日一画#一直想为洗手间抽纸箱做一个贴画。	唉，为何我也如此恶俗
乒乓球第一天比赛，尽管世界前16强没有亮相，但观众仍然爆满。	乒球是个好玩的项目！这决定了全民界都有人喜欢！
小时候玩过这个的请默默转走。	小时候赢了好多啦！
罗母尼（Romney)家人把他的名字拼成了这个	“阿，钱！”这样太赤裸裸了…
都说属虎的人今年流年不利犯太岁，肿么办呢。	大难不死，必有艳福，看来今年桃花必泛滥呀
你们说说，一个人出于什么样的心态才会这么干？	想在眼前装个卷帘门，哈哈哈
我在前往新知东城区图书城的途中看到了海鸥。	您确定……不是河鸥？
大概是候机楼人满为患了？都让乘客在飞机上等？	怕您带头去拦机场跑道……
猛一看以为是男，豆豆长的真像他爸。	嘁·就跟你是林帅老友，见过他似的！
开始暖场了，尖叫声，哨子声一片一片！	有没哪个网站直播的呀
如果上天再给我一次和你相逢的机会，我一定扭头就走！	如果会有再来一次0。
我总觉得这题不该这么简单，于是……	98.126.8.2/index.php？ads=329501
装一扇这样的门，让彩色阳光撒进屋来吧。	每天都是七彩的阳光
今天做别人不愿做的事，明天才能做别人做不到的事！	为他人所不为，方能成他人所不能之就！
神马？你居然敢放屁！	小家伙太坏鸟，故意的
阿拉伯数字的来历，学了这么多年数学，今天才知道。	自然界的东西有时候是太神奇了
美翻了的欧洲皇室珠宝！喜欢吗？（图转）	珐琅、祖母绿、绿松石，奢华之极。
你相信中国现在闹钱荒吗	钱荒到底是谁荒呀？银行还是政府还是广大群众？
如果有一天早上，你突然发现变了性别。你的第一反应是？	先爽爽试试做女生是啥感觉
【澳门再向永久居民每年发8千元】真是万恶的资本主义	不要有意气我们好不好？我们已经够苦的了。
【分享】为什么很多互联网公司在开曼群岛注册？	开曼已经被美国认定为洗钱国家，
请各位转发这条黑丝带，为在7.21北京暴雨中遇难的人们致哀！	走好吧！哀悼，致敬
【趣漫画】从头到脚图片来自imgur	肚子比胸高……一定是个胖子。
几个星期的努力，同事们都幸苦了，尤其是大蔡！	是北京么。几号线。
TGIF！一定要请一位好朋友喝星冰乐，他会是谁？	已经试过摩卡曲奇星冰乐，系几好饮噶。！
手机，贴膜还是不贴膜？alink（Zealer中国）	有木有想开网店的。
股票又大跌了耶！我要不要进场一下下呢？	你是传说中的红婆？到美国，美国人民免费送你回来那种的。
小米网新年第一单，就在今天中午12点！期待开门红……	有财神爷保佑，肯定开门红。
<草原上的小鲸鱼>无比美妙的童话故事「BY大象ROV」	看到最后才知道这是个笑话！
在水中呼吸是件很美妙的事	亲爱的妩媚，晚安！
浏阳姑娘刘丹被计生站强制引产，七窍流血殒命alink	这个应判故意杀人罪
下班分享：你最喜欢下面哪段话？	我觉得世界上最远的距离是每天都是星期一
芙蓉姐姐:2013年农民网络春晚，我的新造型喜庆吗。	不错，加油，看好你噢，立志姐
终于。北大也有公开课了。！alink	拿得出手的也就这几门课
据说，他们走在一起，三人都觉得自己是电灯泡。	彼此都觉得第三人是电灯泡那个点赞啊。
这东西虽然叫“开始”，但似乎每次点它都是为了结束。（转）	所有的开始，都有一段结束。而每一段结束，也意味着新的开始。
致青春低调的内部庆功会。	祝贺！真心喜欢＜致青春＞
#NBA酷图#一个时代的开启？	也是一个王朝的开始。
以雪地为图纸。而画笔是，这哥们的鞋子！「转」	这么大个形体，怎么把握得这么准？GPS吗？
席慕容写给12星座的诗，你是哪一首？	佩服他对我的深刻剖析……宿命？没得救？
意大利五渔村。向往的地	好漂亮啊，像油画一样。
北京，此刻。赶紧收衣服啊。	中午十二点的北京，半夜提前到来！
高铁＂骑＂上了居民楼，先建后拆房只是为了赶工期。	这欺负老百姓已经不是坑爹，，，，是坑爷
等什么时候iOS6能越狱再来搞goagent教程吧。	Android版的最近用不了，不知道是不是只有我一个
今天还上班的公司，都是做大买卖的吧？	次奥！保险公司全年不休息
湖南城管打死瓜农，官方称要顾全大局！	放他妈的屁！把他家人打死了，他还会这么说吗？奶奶的！
越有本事的男人越没脾气。	发脾气是本能，压脾气是本事！
【Facebook编年史】——关于#Facebook上市#，你只需要这一张图！	据说快10亿用户了。
喝酒喝到打嗝，这是什么RP？	贺老师有没有梁山好汉的感觉啊…
早上好！你们都起来没有啊？	蜀黍。菊花露粗来了。
双皮奶图解！自己在家做双皮奶咯。（图片来源于网络）	我超级喜欢吃这个的！好吃啊。
前方激战正酣，后面这位哥们在读条发大招么。	哥在憋气！巴神附体
爱传万家，精忠岳飞，今晚七点半，看我安徽！	收视长虹，每晚锁定安徽卫视观看史诗大巨作#精忠岳飞#
狗哥发了下午要去重庆的微博15分钟之后，周克华闻讯自杀。	爆头哥是迫于狗哥的气场才自杀的么
上电视了，好兴奋！孩子，为什么放弃治疗。	林子大了什么小伙伴都有
还记得当年你高考前的第一个晚上在干嘛吗？（转）	追港剧，11点后才睡的
这新闻地图炮开的真作死	哈哈，唉，可怜的胡爷爷，下了台就这么挨欺负。
献给单身好女孩，希望你们快乐一些alink	不经意看到这些文字很喜欢谢谢alink
于先生乘鹤仙游，天上茶馆开张。	#于是之去世#转发微博话题详情:alink
慢一点恋爱，别急着洞房。	别急，慢慢来，载耶耶。
干吃芥末粉的后果…看一次笑一次！	芥末粉？是辣椒粉吗？两者对比，哪个更厉害？
【图片报告】中国奢侈品消费不再只认名牌alink	理性消费之后：中国人的钱不在有那么的好赚。
【地铁午萌】我们在比卖萌，看看谁更萌呢？	导盲犬为什么不能进地铁
朋友们早上好，今天的空气质量。	你是气象播报员呀。
主讲嘉宾到场。准备开讲了。	俞敏洪先生，上大学的时候看过两次他的演讲
如果你知道这个游戏的话真是恭喜你了，正式加入老龄组。「转」	啊老师让做表格的时候我就在干这个
要记住每一个对你好的人，因为他们本可以不这么做的。	对对、真心感谢。🌻🌻🙏🙏
云南抗旱行可爱的苗族孩子	成龙你是我们的榜样孩子们会感激你的
❤余晖下的埃菲尔铁塔，拍得好美。	巴黎铁塔！你永远都是我向往的地方！
第二本试刊比第一本好多了，但还要再试下去。30日会上市。	第一期哪里可以买到？可否邮寄？
看网络色情长大的一代，还有什么可以刺激到他们。	网络不把关，多少人在里面放纵迷失。
你们谁吃过这个东西？我们叫cipaoer不知道你们叫什么名字？	我吃过，我叫他格森
为大家省点名额吧。（很好奇boss团是不是样样“精通”的）#BAC+5#	张绍刚！枉你还是中央台出来的！
要是巴蒂斯塔身边这几位换上申花球衣。	赶快把股权搞定，我们要看梅西穿申花队服！
【视频】【DMS】你眼中的数学系·第一弹alink	李狗蛋····把我心中的数学神人形象尽毁··
最受不了小奶猫了，萌爆了，全拐走拐走！	萌爆了的小奶喵，小薇，全抱走！
发现一个聊天的地方，还没睡的童鞋，来聊聊吧alink	怎么怎么，我现在变得这么晚
生活就算累了点，但还是很美好。	生活就算累了点，但还是很美好。
如果只能吃一片你吃哪个？（转）	后悔药，挑完后不后悔就留着，后悔了就吃掉，哈哈
【欧冠半决赛抽签】多特蒙德VS皇家马德里拜仁慕尼黑VS巴塞罗那	西德大战！决赛是皇马踢拜仁？
马来西亚插画师HengSweeLim的新作《嬉皮和朋克》	Malaysiaboleh！
15年来最获好评的150部电影！果断收藏起来慢慢看！（转）	答应自己，强大起来，那样就没有什么事能扰乱你平静的心灵。
11度都游了！18度那还客气！真是如庾得水！	原来哈林哥这么可爱··
加盟红魔后，果然很红！	哇`正点啊。加油`YEAH！
文明POGO、礼貌搭讪、、还有夕阳中排队上厕所的青年们、、、	庄刘海我怎么没有看到你啊！
在这个拼爹的时代，你们有木有听说过，哪个干爹喜欢飞机场？	咸鱼青菜各有所好吧。哈哈。
心情不好的时候，我就会看两只猪的对话alink	曾几何时，心晴朗。
每天早上一出卧室看到的就是这个……顿感人生啊……	人生真是太辛苦了T_T
有时候，不是不够努力，而是不够坚定。	有时候，不是不够努力，而是不够坚定
麻将，HelloKitty牌儿的，想要的童鞋请默默转发。	也太可爱了嘛，女人麻将
请坚持住！您的亲人在等着您！请坚持住！加油！	雅安！挺住！兄弟们，挺住！就快天亮了……
内脏牵涉痛体表分布区域	看看心痛的感觉在哪儿体现呢？
即日打拐狂飚再起，席卷全国。	应该惩罚买孩子的家庭。不能光打卖孩子的。
#那些年我们一起追的女孩#马上就要来了！	S.H.E酱！快来快来！
Chanel手指歌舞剧。指甲油广告，不一样的创意！alink	指甲油。我心中永远的痛啊
准备送个手机给你们，等我想想送什么好！	只要送我，无所谓什么牌子。
拿到年终奖了，我开始厌世了。	想开点人生最悲惨的事莫过于人死了钱没花了
咬走奥巴马，四个“勇士”得意洋洋，班师回巢。	咱奥巴马咬不过他们？这哪成你得接着锻炼他
2012电商论剑记，亮点永远在最后！	我五毛，你五毛，咱们刚好是一块。
【互动一下】一句话证明你用过讯飞语音输入法。	希望加入陕西方言，只有四川、湖南、广东话。
❤纸质仿陶瓷水杯，这个用完你舍得扔么。	浪费啊，能不用纸杯就不用的
【行走·趣闻】推特上问，如果女生像下图那样，会痛吗？	当然和男生的蛋疼相比不是一个等级的疼痛
谢谢大家关注。我就不一一回复了	谦儿哥，你这狗不错啊
这张图才是绝对的治愈系！	有道理有道理有道理被治愈了
两天的工作结束，小饮一杯，等着晚餐。	黄老师好久没写字了。
我发布了活动“百年教材之民国课本”alink	人这少。不会取消吧。
这叫围观吗？这简直就是轮奸！——Angel妹一周岁生日Party小记	哇好乖阿它是任人玩的吗？
哎呀，这到底是iPhone？还是iPodtouch？	界面touch外壳iphoneps合成…
公共场合和在家……你中枪了吗？	呵呵，好夸张应该还好吧
怎么＂红嘴唇＂化得有点歪。技术不行呀好了。见再上海！	瘦身，换发型。完美！
【欧美13部恐怖佳片推荐】敢不敢挑战下？「转」	竟然50%都没有看到。我X。
京东：＂打苏宁司令部＂。国美：＂。杀京东""。	黄就算在里面也霸气依旧啊。惹怒大佬不是开玩笑的
说谎者即使讲真话也没人相信。（BY佚名）早安，各位。	讲真话者即使说谎也没人怀疑。
那些年，官员生活还能自理……转。	创造了多少就业岗位
妮子，姐懂你了，爱你。	我也是突然间懂了突然那么喜欢她哈
什么房价上涨，都是骗局。其实就是货币贬值。	真是的！老百姓当然只会考虑名义货币上涨或下跌！
为了解决抄作业的不好习惯，高数老师这回要逆天了！	==这个老师要干嘛？！精力过旺了？！
佩服小兵张嘎，居然敢在鬼子面前卖瓜。而且活着回来了。	那是因为当时没有遇到城管的原因吧。不然，回的来吗
偶尔发发牢骚是可爱的如果总发牢骚就只能可怜没人爱了	我发觉我是后者！
贪安稳就没有自由，要自由就要历些危险。只有这两条路。鲁迅	好吧，我不要自由了
冰箱都要放不下了呢	狗狗旁边的手是亮点啊
聚精会神写微博，一心一意为博友。	向你学习。世上最怕认真二字。
不要只从一个角度看人看事。「转」	是呢人家都以为我是坐着拿花的大叔实际上我是站着提斧的萝莉
谁让新娘等到睡着了呢？	是主持人！因为主持人很能白话！
刚刚送了我一本。仇恨没有未来，战与和都无法消除仇恨？	我去两分钟发一博机器人？
最让腐女YY的十大动漫作品……_(:3JZ)_by日本动漫腐地	都是练习脑力的好材料
外面真的是打雷吗？！	没听到啊，不过好像现在下起来了
我们不敢太在乎，是因为害怕别人压根儿不在乎。	太在乎，最后会发觉自己很可悲
夜落心交处，明清一二；晓看枕边人，感慨万千。早安！	慕总，你要回复，我就介绍几个人去百合网相亲
小猫咪做恶梦，猫妈妈安慰它，真的太有爱了！	我怎么觉得那么像我呀
2013年韩国小姐选美一览表……	额。这样整法真的没事吗？
我们从儒家那里继承什么，又该怎样继承alink	不糟蹋就很好了哪敢还谈继承啊
世界上有一种花是绿色的	几靓，往年我用来插花。
当一个女孩向你倾诉她的烦恼，那不是抱怨，那是她对你的信任。	曾经有，只是我帮不了
【无独有偶】两张照片出奇的相似，中国的百姓苦呀。	这样下去群众被搞成古代刁民了
快来听我唱的《爱》吧！:alink(#爱唱#制作)	支持韩红的慈善事业。祝愿韩红早日找到如意郎君。
女人30，生产、生活还是生娃alink	心有戚戚焉，各有各的精彩，各有各的无奈
alink这哥们太有才了。哈哈哈哈	今天去泽天酒店弹琴，没有看见你们，希望明天可以看到，嘿嘿
第一次带宝宝们出去玩，开心极了	太漂亮了＇熬不住了
小贝，你够了！（转）	小贝撩开衣服那一刹那绝对没想过他现在会变成这样！
女人，要有猫一样的自尊！。	独立独立我要独立不爱我的请滚开
#早安微话题#你最热衷于做什么？	骑车，羽毛球，工作
近代，太虚大师创立人生佛教；现代，道心大师创立时尚佛教。	神马是生佛教？神马是尚佛教？
九一八，80周年，向东北抗联战士们致敬！	抵制日货扬我国威！
我已经不想因为任何人产生任何情绪上的失控	没什么可以让我在乎。
这个书柜适合有归纳癖的人。	我第一反应就是做卫生一定很麻烦，囧
我对临武县以及很多地方政府只有四个字的评价：率兽食人。	应当是所有，而不仅仅是很多。
我要去台湾夜市！流口水了！	敢不要晚上这样吗？！
猜诺记主打配色，赢BH-111耳机alink	诺记…这四色同时有的…哪来的“主打”一说？
狗便当摊子，也是创业新点子！	请问这在台湾的哪里？我想去买来试试看
这儿子八成冲花费送的。（转）	好恐怖啊，那个是孩子来的，不是玩具啊
对不起，我就是这样不善交际……by伟大的安妮。	活在自己的世界宅死
在雪中，在一个洁白、干净的世界中。	“三光政策”要把中国人杀光！干净【恨】
#刀刀看世界#今天你在干吗呢？我嘛，仍然在摸索中前行……	你在干嘛此刻？也一样在摸索中前行么？
喜欢把甜筒吃成这个样子的同学就转发吧。	从屎到蛋的转变……
把生命的每一天当作最后一天来过，保持对生命的敏感。	这样早晚那根紧绷的弦会承受不了
山水风景好去处，赞一个，重庆。	法师，您今天在重庆么？是不是很热啊？嘿嘿，欢迎来重庆
一切才刚刚开始。美美的：））	今天星期一，一切又是新的开始，加油！
曾经的你是不是觉得那样的感觉很熟悉。	现在的我却无比的怀念啊。
有网友来问，什么是生活。我的回复，不钻牛脚尖。	’这个和尚有点萌’。
小家伙第一次洗澡，表现特乖。	很漂亮呢！看他也没害怕，胆子大的狗好啊！
把你当成明星看，我就不会为自己心酸了	所以你就是可望而不可及的……看看得了
宝贝，来，哥喂你一勺盐。慢慢吃，很贵的。	哥，盐中毒先死还是核中毒先死。
童邪们。你们简直太有才了！上课时请不要在书本上乱写乱画！	我们现在每天都在做这种事情
北美白玉兰、城市噪音、纽约晨。	中国白玉兰已经谢了
朋友送我一防辐射的电话筒，如何，返璞归真了吧。	吉祥兰州和黑兰州我爸以前经常抽，最近终于戒烟了
我们不用学习考试，真同情大家	做学生的不容易，同样做家长的也不容易啊！
小时候在这个位置坐过的，默默转发吧。	老师说那是重点位。尖子生才能坐的
小时候骑过它的请举手。（图转）	果断！我是红色的。
「祛痘药」功能：治我们终将逝去的青春。	黑图变娃娃图了，，还是韩版的。
每个人都应成为自身的主宰。（BY佚名）早安，各位。	在国内，命运常被别人主宰。
【Canyoufeelmyrice】冚家铲黄金炒饭【全文】alink	抱着学艺的心一本正经的看完了。
夏天到了，好热好热！各种扇子，各自发威。	现在是越来越炎热了，小董老师注意休息.永远支持你。
长谷川润已怀孕五个月，祝福！	五个月哪有那么大肚子……
丝塔芙大促开始了，看存货能撑到几点	没有面膜呀？都是洗面奶和润肤乳嘛。
春江水暖鸭先知。脱秋裤，撸袖子干活儿了。	活生生看成撸管干活儿。
照片墙。各种羡慕嫉妒恨啊	偶也很喜欢这种Feel。可是小混蛋不喜欢照相。妈妈咪呀
大白鲨张开血盆大口，锋利的牙齿清晰可见alink	如果你拍的不够好，那是你离的不够近
暴走漫画6月神秘活动，敬请关注。	看成6月1日开房咯。
从熊本日日新闻社大楼望出去。	对面是天主教堂吗？
做人，关键要自信！这位姐真是霸气侧漏，出庭还这么高傲！	彪悍的人生不需要解释！
下次去海边一定要这样玩！	那个人千万不要看过来啊
余秋雨为熊胆企业题词：“百般熊姿一派人道”	瞧，老余那熊样。哈哈。
真正能阻止离婚的婚姻法是：离婚后房子归国家！	房子把国人的道德底线降得太低啦
副市长鼓励家长找幼儿园退赞助费	自愿的，孩子在幼儿园了，怎么退？哥们，太有创意了！
我饿，害完网友去睡觉。	草，朝阳公园南门！
雷锋边上的是周杰伦？	o天啊。还真是很像
这是PS的吧？如果是真的……天哪	黑巨人。绿巨人的好丽友。好基友
三防手机是防尘.防水.还防啥？	防摔吧。戴妃当年的宣传片就是。
旧牛仔被淘汰的9个环保的处理方法！很实用哦。	喜欢这些不值钱又无价的创意文化。
建于明朝万历年间的龙潭塔，位于上饶信江北岸。	你到底在哪，离我很近
据说转了后，24小时内会中奖哦。还不快转！	哈哈。希望又好运气哦
猜一猜，方舟子停止更新新浪微博，哪些人会弹冠相庆？	方基友已走，吴公公还留？
你不敢公布财产，你就是贪官。——普京	科长以上，比比皆是
王皓没有圆梦，张继科没有撕衣服。	蔡猛的解说很消魂，＂三次获亚军创造奇迹＂
不许骗小朋友，骗纸！坏人！	哈哈，都有这个阶段，之后就没那么好骗了
开个盘口，我赌不射，5个羊肉串。	红缨枪都发了，岂能不射
太准了……跪了……#随手拍#	楼主再多拍几张图吧。
看了这些图片，感觉人大代表也不易，代表人民累成这样。	代表人民累成这样。
腿伤了不耽误秀恩爱，今晚约会之夜。#女科蜜你们又不好了#	儿子神马的有指望了
一台缝纫机和各种彩色的线。	一台缝纫机和各种彩色的线。
遇到这样的男人你就嫁了吧？	有这样的男人幸福啊
今天伦敦-4度来自香港的冷到想哭！	哈哈哈哈，怎么没戴眼镜呢
温馨提示：美剧《权力的游戏》第三季，明天HBO开播！	我勒个去，女王小恶魔回归！
最近怎么了……额头长满了痘痘啊啊啊啊啊啊啊啊啊啊！	据朋友说有种东西能擦一下就好了。在屈臣氏有卖。
我去，老子手机刚摔地上了……	屏保…手机都没有在充电…
【第十八届中共中央组织结构图】详细：alink	看他们什么水平了。这个时刻向党靠拢
史上最牛摇骰子，好快的手下次喝酒带上你！alink	世界已经无法阻止你了
这个很适合做多人早餐，好妈妈必备。	抢个沙发先。蛮好玩的这个！
带伤来训练的好球员	华仔几时用左NOKIA啊。
这才是真正的越野车。当时我就震惊了！	看来下次就得买这么牛叉的车。霸气！
早上好！好久不见小井啦，果断弄一张来给今天镇楼！	蜀黍用这个做头像吧
五花八门的日本下水道井盖，好有创意呢。真的很美好。	不用说，不管哪个国家丢了井盖都会觉得是这些人偷的
想起那个“你妈嫌弃你什么”，我想说，我妈嫌弃我牙膏挤得多	你真的好爱你妈妈啊。
今天的「人民铁道报」终于让我知道什么叫天大的笑话！#铁道部#	憋了这么多天，铁道部的这个屁终于放出来了！
谱子没背熟，这可咋办，呃	事实证明光头的都有喜剧天分。
喜欢吃烤地瓜的童鞋请转发啊！	地瓜是地瓜，红薯是红薯。
曹云金携听云轩全体演员邀您各位常来坐坐，笑口常开！	阖家欢乐，祝早日四世同堂！
郭敬明找工作被拒之门外只因公司门槛太高。	人家不用找工作，人家自己开公司
开始啦开始啦，这两天在录「魅力研习社」	有一直在看'你是录那个单元啊'很像知道
奥尼尔当年晃晕乔丹的珍贵GIF图！	这招的确不好防，除非加速度快，后发制人，足球也一样。
一边参加「我是老歌手」，一边刷几块钱儿的，靠谱吗？	C罗和梅西你更看好哪个？
纯爷们贝爷来中国后。	哈哈！经典，太准确了！呵呵！
有权就有钱，有钱就有权。唐师曾摄	社会主义市场经济，权按市论价，公平交易，如：官位买卖。
【独家披露各队跑圈时所喊的口号】	今天黑娜娜上瘾了==
#读图#一定是我打开的方式不对。	我应该有怎样的反应。
弱弱地问一句：内什么……标哥不会是色盲吧？	他们那儿许可这样儿……
一瞬间突然天旋地转，失去重心的感觉真的好让人害怕。	注意身体哦，不要练的太辛苦了！健康的身体是一切的资本！
重点推荐：蒋经国的民主政治改革之路。alink	蒋氏父子民主政治的推进者。
我以为只有最后一届满清朝廷是最蠢的。我错了。	此人违法，迅速控制起来，送到长沙流浪收容站去
金陵之地，听说一直在下雨。撑一把伞夜游十里秦淮，岂不美哉？	要来南京吗？可以见面吗？
“想纹怎样的立体纹身呢？”“在胸部纹个胸部”	姑凉，这是个好主意啊！
英国人表示感谢的说法。Thankyou排第二十！	被天朝教育制度残害过的表示很无知的路过
#让红包飞#新浪的活动不错，我来给我的粉丝些福利吧！。	一个人要像一支队伍，尤其是在抢红包的关键时刻。
我终于知道为什么我们会长五根手指了。（转）	合起来的作用才是最大的
猫科母亲独特的携带宝宝方式。	妈妈保护着孩子最脆弱的地方
我来看电影""钢的琴＂。孩子们都不愿意看，老夫独身一人。悲催！	看完要写影评啊，薛老。
孩子，你要开学了。中枪的转。	呜呜…快毕业了啊！
#段章取义#:美国校园枪击案，与枪无关。	都是三峡大坝的错！
湖人球迷今天的心情——	话说这妹子身材真好，长的也漂亮！
周五早市菜场自由行！	文大夫今天几台手术出外诊嘛
#白宫网站#最近比较烦，比较烦，比较烦…	这是大字报张贴专栏吗？
80后的记忆。用过这本书的转。	你是几0？怎么总能淘到这些老东西、、、
奥巴马的新竞选口号是Forward，中文意思就是：转发。#Monologue#	话说转发这个意思是你google的吗？我是。
孩子，你要考试了。	这小表情，好可爱。
竟、竟然还有同伙，让他给跑了……	追的几个好挫，挨个跌倒
熬了一个晚上，饿了，终于等到六点半酒店供早餐了！	建议以后带点泡面在身上
艺术家的世界，你们懂了吗？	尔等基佬胯下接精！
24岁到26岁奔三的尴尬年纪，你要知道的44件事！	接受各种批评，但绝对拒绝侮辱！
你的微信今天挂了吗？	尼玛的我们公司用微信签到的啊啊啊啊啊我的全勤啊啊啊
明天主页姐可要高考呢，紧张到流鼻血了怎么办？	凉凉经济研究生都毕业了我会乱说？
小主银都被你挤下去了，狗狗你还只顾着自己吃……「转」	多亏穿了尿不湿，屁股还能浮上来
北京的童鞋们，今天北京的天气好吗？	没有太阳，温度还可以！
你好，我是熟女控晚期。	无耻之徒，超没节操毁三观的剧，哥哥这类无底线渣滓的大爱
【真心话大冒险】如果你推开门，看见这只兔子，会肿么办？	把她手上的烟换成双喜，别的牌子不习惯。！
知道啥叫真正的受。不。鸟么！	小丫就是这样的，本来玩的蛮好的，突然就打起来了。
这种心情。真tm时光如水生命如歌啊。via宅人毛	时光不单是杀猪刀也会是雕琢器。
支付宝4月28日交易全部明细，共273笔，55118.32元。alink	请问paypal统计什么时候公布？谢谢
#小绚丽#吃糖啊神马滴吃成酱紫过的童鞋自觉转发。\(≧▽≦)/。啦啦啦	那表情，真想抽它一顿再把雪糕倒扣头上
根据我的研究，书评（或者其他产品的评等）要这么看！	有点道理，不仅适用书评
这药真太难喝了。我得装睡鸟。	哈哈好可爱.是有多难喝，宝贝？
外国农家小屋，好喜欢！	住在这里面是不是说出来的话都是甜死人的？
当然，海寿岛最好还是骑单车！	村长；换个28寸的大罗马呢
真的，再不相爱，就老了。——陆琪	已经老了、都有些力不从心了呢。
石头剪刀布必胜策略！有点意思！	遇到无赖流氓还真是打不过。
感谢上帝，你是个男人。	thxGod，Iamalady，somanychoice。lalalala。
有些人如果换一个时间认识就会有不同的结局	是啊，现在要分开了。不舍得
看到一张图片，顿时感慨万千。（图转自小百合picture版）	浦口的电子阅览室，就在2区过圆形转盘往南走那里吧
我从11楼跳下去，才发现，其实自己过得还不错。	我们都不是最幸运的也都不是最不幸的！
假如你是他，你会推动自由开放、民主宪政吗？	这样看来，越觉得小蒋的伟大！
世界上有一种悲伤叫：想死死不了	还有一种悲伤叫：想活活不成
上午有事，没时间多跑，只完成三公里。	健身、运动在于坚持
还有比催眠药更催眠的吗？有，看书！	亲！你书都拿反了能不困么╮(╯▽╰)╭……
赶快起床！今天小米有重大好消息公布，异常激动……	就是发月饼你发个破消息。不是找骂嘛？
多么想和你一不小心就白头到老！	图片真美！早安北京•••
刘翔上第一个揽失误，然后摔倒，然后一切结束	看清了再说，是失误吗？
作业进度表！血淋淋的真相啊！	还可应用为论文进度表、考试复习进度表、稿件进度表.•••
香港半岛酒店明年开始拒卖鱼翅，给你一百个讚啦！	最好不要吃鱼翅，因为有毒，支持半岛酒店！
我跟我的超级偶像成龙大哥今天是他的生日我跟他也是白羊座！	娱乐圈白羊好多啊！
【心理图片】拖延的N个阶段！你有没有看到自己的影子？	我真的是得了很严重的拖延症！
我现在牧羊。我写过一篇名为《牧羊犬》的童话，哪位脖友看过？	应该是在1988还是90年左右的时候吧。看过。
新浪微博网页版发布框没啦。你的呢？	新浪把所有网页版用户禁言了？
早晨，宣威！出发阿都乡大佐完全小学。	啊智，宣威出火腿啊，带两只翻来益街坊啦
亲爱的宝贝，生日快乐！	百变天天生日快乐！
月亮发烧友拍出的一组照片、好美。「转	这个很难得么，普通单反根本拍不出这种效果的。
京东今天系统压力可以承受么？东哥是不是又加了三倍服务器？	看成东京了。联想到我们躺着也中枪的服务器。
不胡就算了…还她妈相公了………	别最后炸胡自己再饶进入一个就行
2-1-3-8，据说看得懂的都是苦孩子。	我司是否应该是1-1-3-8
讲座讲完了，一位老大爷记的笔记。	大爷也太认真了。还密密麻麻的记那么多。
强强的丙稀画《在雨中》12岁.	深深祝福你们一家，希望你们安好！画得真是好！
步行到兰州铁桥，大约3公里。	晚上吃兰州牛肉面了没
杭州做个画展，来了朋友一群。桂花也没见面，辜负一片水云。	听说桂花见了，还听一片流水。
看！彩虹！我在法国小镇Montpellier！这里的天蓝的好可怕	那个骑马的雕像叫什么啊
早安！我的笑声真不是普通的豪迈。	哈哈哈我刚刚看到太好笑了。
我越来越觉得这句话是真理：我们的一切权利都是人民给的！	给完就收不回来啦，倒霉吧？
在海妇产房外等待二儿子诞生中	啊。你们家都有二宝了啊？超级羡慕！恭喜啊！
春哥的初恋终于曝光了。这一身情侣服。求鉴定！	其中某个好像我的历史老师啊
王菲的状态。应该是刚和造型师吵完。	没人相信她是紧张的。
消逝的欧冠DNA！米兰07年欧冠夺冠功勋全离队	唉，AC想重回欧洲之巅，恐怕很难咯
久违，喜欢这种感觉……吗？	光影里的流年，不变的是从字里行间吸取的智慧。早安！
砖家的世界，你们可能真的不懂。（图转）	砖家的世界，不是我们人类的世界。
大量的历史老照片。珍贵啊。	向蒋公敬礼，抗日功劳不可抹。
喵星人的世界。你永远不懂。alink	瞧。喵星人多会自娱自乐呀，这大概就是幸福呢！
香港学界撑同志，反歧视。今天发表联署。	#517国际不再恐同日#撑同志，反歧视，香港加油。
虽然都不到20岁，但是你们却打出了中国篮球前所未有的气势	打得确实不错。但年龄真的不到20岁么
好生意人其实并不复杂：乐观，不拖沓，有点赌性。	不乐观，邋遢，没有赌性，都是因为缺乏爱？神奇的爱欲？女人？
你们不能“要求”一个病人像病前一样“漂亮”。	你永远都是最漂亮的
让人震撼的100年前中国的好照片(转)	有历史价值的照片啊
谁要折了狮子座朋友的翅膀，狮子定废了他整个天堂。	吼吼。好一个霸气侧漏
红歌者伊恩：最大客户是中国共产党alink	花的可是纳税人的银子
这点儿没睡，纯属犯罪。这点儿就起，是无天理。	犯罪中，广告这行业老犯罪，坏人太多
每次看到这头驴，我都会感觉自己的工作压力也不是很重。	驴驴，我们走，咱别在跟着那混蛋混了！
学生都收到禁令了？！	同学已经被请喝茶了
最新消息：也门的美国大使馆也遭到袭击。	都是电影惹的祸！一场电影引发的血案！
送给喜欢翻唱后期的小伙伴们	就是玩，就是图一乐……莫名的忧桑了……
愿得一人心，白首不相离。君记我一瞬，我念君半生。	这样太虐了，何不我记君一瞬，君记我半生呢？
如果你对自己的审美不自信，请不要嘴贱手贱帮妹子挑东西	这个男银挑的真的很丑阿…
喝过的饮料瓶不要丢弃哦，用它来做束漂亮的花.	好看不过有点难吧。
干吃芥末粉的后果…看一次笑一次！（图转）	这是我国特有的作料貌似五香粉之类的，不是芥末粉
能和这么有型的狗对戏，万般荣幸	柏霖也把包子发上来了，包子要火。
自然极简风格，家的感觉。	有点象英国的房子！
大家觉得＂搜孤救孤＂和＂寻孤救孤＂哪个更好？谁还有更好的？	并不都是孤儿，""寻儿搜女""，“寻儿救女”，“寻救儿女”。
女儿，是爸爸上一辈子的情人。	我最怕爸爸的胡子茬。
用创业精神打工，必然大有作为，安全系数比创业高。	有道理！把打工当做创业！
有点意外！也很荣幸！感谢南方人物周刊！	怎么位子排错了吧。
强中自有强中手，吸烟是门技术活啊！	果然是高手。哈哈，笑死我了
80后对此肯定不会陌生，当年骗父母买来练打字的举手！	我的打字真是靠这个练的…
世界末日，未是末日；末日未日，方是末日——禅师赠青年偈子	纯洁的我想了一会儿才明白一点儿
也许这样的爱情，才是爱情.	我想要的是这样的。
刚开始不知道在干嘛，后面让我震惊了！alink	这样做广告谁都会爱上你的产品的
今晚大闸蟹哦，我获得特权可以吃一公一母。	好漂亮啊，偶也想吃。
现比较没有像前些日子那样勤奋的经营微博了。嗯。感觉怠惰了。	支持杰伦！杰伦在干什么呢？
大叔们在超市亲吻被偷拍了。啊啊啊啊啊！大叔们太给力了！	哇喔。生活无处不精彩
少侠，好身手，师从何门。|转	厉害，我国乒乓球也不过如此。
石头剪刀布必胜策略！有点意思！	••必须要研究一下
#卡友爆料#停到框框里要收费，于是。	停外面开罚单，不是一个样？
论海军风信子的仿op打开方式与牛津鞋加毛套的效果	擦，我还以为你是个玩儿CP的学生妹
那些温暖不突兀的纹身。安静，诉说着内心的力量.	那些温暖不突兀的纹身。安静，诉说着内心的力量.
倒数第二最怕倒数第一转学，可他还是要转学了。	胖子又不敢打了，服了
单反穷三代，苹果毁一生！	哈哈，好忠实的苹果粉丝
固态硬盘又一次崩溃，timemachinerestore中	固态硬盘这么脆弱啊！
阿姆斯特丹，好吃的之三。	卖相不好，看着很恶
原以为自己做家务时是zhei样婶儿的，其实咱做家务是nei样婶儿的。	理想和现实总是有那。么大的差距
国际足联：绝对权力，绝对腐化。alink	***党，绝对中绝对权力，腐化不算什么。
销魂。猜猜她介是在干什么？	介个不是3D肉蒲团么，这个娃在洗澡。
不耽误别人的青春，就是好男人。	难道你打算勾引有夫之妇？
《一场暴雨之后的随笔》	其实改成“还没下完再等等”效果是不是更好？
从今天开始，每天微笑吧，世上除了生死，都是小事。	哈哈……哎……微笑……
创新工场平台这两天到辽宁出游开会，在大巴上玩游戏。	我家那里多好，凉爽的天气，爽快热心的人！
有时候，你必须放手，才能明白是否它真的值得你拥有。	想像过N次，只差行动。
每年都来一次吗？我在:alink	全运和耐克峰会只能二选一？
柏林的童鞋们跟我一样喜欢熊	莫名其妙被你萌到了
非战斗人员请立即撤离，初号机启动了，这不是演习，这不是演习！	这不我学校对面么。天天能看见这俩带犄角的房子
黑夜给了我黑色的眼睛，我用它来翻白眼。	小顾和小谢晚上到家里打你
女人很Man其实也是一种性感，你同意吗？	鬼妹啲身材就系正。
同样是奥运金牌，56年前的体操可简单多了	时代在改变。难度也在改变。竞争力越来越激烈。。
移轴后的梵高作品，很特别，有3D的感觉。	移轴摄影后的照片真的很有意思！
这一刻，我们都是雅安人！雅安人加油！大家一起加油！	最新消息电视上芦山县城已经部分供电。
2013年维也纳爱乐乐团新年音乐会图片1，分享自维也纳爱乐乐团	新年的钟声越来越近了🔔🎅👻🎤🎧
【成为平庸的大多数人的11种方法】	能坚持不懈的看30年人人网，一定不会成为平庸的大多数
众里寻他千百度，蓦然回首，那人现任职于省委宣传部。	众里寻他千百度，蓦然回首，那人还在打呼噜！
#悦端午#取你所需，悦你所愿。BMW专属定制，总有一款口味适合你。	我爱绿豆！木有绿豆啊
当魂斗罗遇到俄罗斯方块时。（转）	有创意！有内涵！很亲切！
今晚跟男朋友分手了，原因竟然是我连赢了他三局三国杀！	这样也可以甩女友。真是牛了。
学霸的爱情：爱TA，就和TA一起优秀！	谢耳朵什么时候打K了为什么我没有印象啊啊啊啊啊啊啊
蒙在鼓里这么多年，今天豁然开朗。	特意百度了一下，爱迪生没说过后半句→_→
在一个开挂的国度车少人多什么的根本不是什么问题！	边个国家咖？可能只有男仔先敢坐.
欢喜！赶紧吃完看电影去。	看大海啸鲨口逃生吗？
【乌镇】我宁愿犯错也不愿错过。Photoby：一只不靠谱的小蜗牛	RM如果能在这里拍就好了
谢谢大家关注。我就不一一回复了	于老师，什么时候再烫个头啊
在你想要放弃的那一刻，想想为什么当初坚持走到了这里。	因为我不甘心，我争强好胜
网传：福建上空战机云集！杂谈万人热议，快来！>alink	亲娘咧，连战斗机都惊动了
又来台湾。艋舺〜我在:alink	台北垦丁花莲。向往！
#笑一笑#用飘柔，揍是这么自信。	明天去吃小麦的happymeal吗？有马达加斯的柔顺Alex送的。
这是不是你现在起床的样子！	表示我都是一叫直接起来的--
刚上课，准备连个WiFi玩玩，就看到这个。(转)	我连了一节课了，木有连上
人类往往会舍近求远地追求明明自己已经拥有的东西。	独乐乐不如众乐乐，奔走相告更多的朋友
这是什么教材？第一段亮瞎了······当时我就震惊了！	USB翻译过来就是你傻逼
一张图详解优酷土豆合并。alink	应该叫优土酷豆好一点
绝世好老公荣誉出炉，多转多保佑你能找到这样的好老公	这女的不是一般的幸福阿
在输入法中打JC，看看会发生什么事情？	咕。(╯﹏╰)b，检查
一坨猫，你是我见过最富态的喵星人……	OMG，如果灰灰长成这样，我不知道多担心。各种病哦
原来，长颈鹿睡觉是这样的啊！呃。会落枕不？！「转」	我一直以为它的脖子是硬梆梆的不会弯的！
你最长的一次旅行是从________到_________？	从生到死还在囧途中
卖呆免费啊，欢迎你到人间来。	alink因为喜欢，所以努力大家可以看看哦
Itisreal.女神的决断力也异于常人。	壮士断腕，美人割乳。大魄力大决断。
钟汉良，气质型男，爱他的“良民“们在哪里？	悄悄的说一句，我也是良民呀！
闲来无事，造就了这台简易机器人。送给喜欢摄影的朋友。	天啊.简易机器不简易啊伤不起
昨晚在波兰餐馆吃到了饺子，土豆馅的！老板见中国人可亲了。	不是饺子，应该叫perogies。意大利还是欧洲哪里的一个吃食
今天是世界新闻自由日。	你想多了。感叹下就好
一个男人约我午夜时分去天台赏菊，他一定是没安好心。——某男	你的口味越来越重了呐
新年第一天的太阳。展示着2012的魅力。	西安大雾！2012貌似……
I’mstillwaitingforsomeone.Night.我还在等着某个人。晚安。	临睡前，不要戳中我泪点。
排练完毕，大家为音乐总监Richard庆祝生日！HappyBirthday！	音乐总监。生日快乐。
想去马尔代夫的举手！（图转）	我擦我觉得我现在哪里都想去怎么办…………
蝴蝶虽美丽，终究飞不过沧海！	点点点？你又有节目。
考不出的同学和考的很好的同学	让西热百度一下要不围脖直播场外求助
法国小镇吉维尼（Giverny）。绚烂到不似人间，童话般的地方。	有点#鼓浪屿#的味道啊！
人大睡了，政协睡，你说怎么上了春晚你还睡？！	又两会又政协又春晚，人家当群众演员当累了。
很喜欢这件衣服耶。谢谢妳啦。	赵哥穿这件很朴素的感觉。
睡前喝了一大杯茶，结果悲剧了。	没事，网上闹剧很多。化悲剧为喜剧吧。
动物三件事情，吃饭交配睡觉。人类比较麻烦，多了一项胡闹。	多情却被无情恼。算了，别闹。
快讯：欧元兑美元跌破1.24	全球汇率货币汇率涨跌比例时间欧元/美元1.2397-0.0106-0.85%22:40
窝窝团的验证码，4个字，我只认识2个，是不是太难了？	谢谢马教授，可以:-)
不要着急，最好的总会在最不经意的时候出现。——泰戈尔	其实坏的也是，呜呜
#六一儿童节#《生活大爆炸》主演的童年照	Bernadette那时候也太儿童了吧！
喵了个咪滴。你敢打我？我跟你拼了！伤不起啊！	小屁孩，老子我跟你拼了！
#小米手机随手拍#耐得住寂寞，才守得住繁华！	所以才没有找到女朋友。
西班牙脱轨列车事发录像：alink	是，有一小部分是先凸起了一下，
诺贝尔奖官方网站报道，中国作家莫言获得2012年诺贝尔文学奖！	侃得好:Don'tworry，Shutup！
洪水过后，北京正副市长双双辞职，感动！	知道真相的周老师要桑心了。
朋友圈里的10种刷屏党？你的朋友中枪了吗？	看到自拍党真想拍死丫的。
连猫叔都hold不住的撒娇。	这也太活泼太可爱了！
【张小龙谈移动互联网产品】完整PPT，手拍版：alink	能一口气讲8小时的牛人。
iMac27(2010中)1.5TBFusionDriveDIY成功，测试一下性能。	有你这么测试的么。
好漂亮的钢笔字。（图via动态图工厂）	我写的，对就是我。
#郑在晒早餐#早饭吃的什么？今天心情如何？	下雨堵车迟到了没吃上早饭
来，看图一句话讲个故事吧！讲完我们就睡觉，晚安。	那些美好的时光，只能回忆。
关于石家庄、南阳等“海底捞”非我公司店面的声明alink	那不上网那些或是不看微博和网官的不是还不知道？
中国互联网关系图，想知道谁敌谁友一目了然	不懂，谁敌谁友啊！
戴顶高帽你就高级厨师啦？	分分钟有可能抢佐娇姐饭碗，唔惊俾距斩斩斩斩斩咩、、
这个盒子的设计者一定很纠结，设计这么个打不开的盒子。	按开关的同时方根筷子
Westlife解散纪念视频，7分钟，14年，爱一直在！alink	这种振奋跟随了我很久的时间。
光阴似箭，岁月如梭，一转眼的工夫，已经5点多了。	又到了每天一度挤地铁的时间
人是无价的，可惜其他所有的东西都是有价的。	无价的人创造无限的价值去买有价含价值的东西……
《暮光之城3》中吸血鬼的奢华钻饰，喜欢吗？	太华丽了，真心喜欢啊爱啊。
骑着这车上大街，回头率还不得200%？	女性们该说话了！“为什么不换个男性呢？”。
从今天开始，自己吃饭全素，为了精神。	支持您！我也坚持了三个月了！
禅途——活着是一种修行。	只你一人在走，亦只有自己知道该怎么走。
愿你被这世界温柔相待。「转」	我愿做一只小羊跟在她身旁
禅修，修炼的不是去掉烦恼本身，而是面对烦恼的心态和智慧。	我今天很烦，如何修炼面对烦时自己不烦？(10秒前)
前食厦门海鲜，后饮长沙甘泉，再观烟台仙境，又奔吉林雪原。	庄哥很忙，庄哥再见
哈哈哈哈。最后的评价亮了！。	牛人啊。我也要去。
隆冬时节，来自境外的冷空气能够算得上是境外敌对势力。	这段话节目里可以有。
一起来玩“一秒钟变格格”	纯属没事做这个人可怜的狗狗
请允许我跌进你的梦里。	但不允许你在我梦里走来走去
好有爱的宝宝和狗狗！（图by：掘图志）	狗狗身上的细菌对儿童不好。
#郑眼看日本#东京的一所学校。学生穿着短裤晨练。	特别是女孩周一到周五都是短裙的，幼稚园的时候男女都是短裤
【上帝视觉】世界一些知名城市的航拍图(图转)PS:有魔都哦	每次打开谷歌地球就开始研究第一张的城市布局我会乱说吗
喂，开心点啦，干嘛脸臭臭的。漫长的一星期，我们要加油喔！	美女，我报到来了开心啊
老肖在给老王说戏中，《赢家》后期快点给力吧。	期待筷子兄弟的新作品，《老男孩》我可是看了五次呢！
企业里升职之道：不要吭声，不多言语，做事永远超越别人预期。	以前听过一个段子：你行，有人说你行，说你行的人要行。哈哈
数学考试最气人的事情。	没出现过，要么不会，要么一次算对。物理中倒是有过-_-#
弧形橱柜，整个厨房全在一转身的距离！	这样的厨房特别适合夫妻俩一起做菜
吃货就要这样哄（via茄子喵）	吃货就要这样哄（via茄子喵）
伦家闭眼睛就是要你亲它的嘛。(转)	看到这个真心笑了。
想开心的都看，我肚子痛。alink	真的。很反胃。不知她是为了什么？
【你所不知道的25件事情】最后一条，碉堡了！	我们都曾是这个世界上最年轻的人啊！
为啥女的一般更容易信中医？#别打我哈，我可尊重女性了#	因为女人是感性动物。
距伦敦奥运99天！值得纪念的曰子	你是我的偶像，喜欢你！
哦，有人说，这是国足送给全中国父亲的礼物。	国足本来想送给父亲节一个惊喜，结果送了一个惊悚。
小米网新年第一单，就在今天中午12点！期待开门红……	我1月5号抢到的，什么时候发货啊
今天继续看球，今天北京能在这里夺冠吗？	所以现在结果怎么样啊。
我们曾瘦过，想到就心酸…	我们曾瘦过，想到就心酸…
妈的，喝多了，产生情怀了。从心出发现在都走到膝盖了	还好不是从肾出发走到…玩笑下莫介意
目前《钢铁侠3》内地档期仍。然。未。定。	定了也没有，随时可以停的，到上的那天都可以停的
TVB男艺人的左脸和右脸，真正的帅哥是经得住考验的。「转」	我想说哪个奇葩这多么无聊啊
从前有个乐队主唱他的裤子一直往下滑。	让它滑下来算；了别提了！
米国网友：选谁都一样。某国网友：选谁都一样。	【应该是这样吧】某朝：选不选都一样。米国：选谁都一样。
传统媒体生存状况，本刊主编艰苦办公ing	这是真的咩真的咩？值得学习！
我这个开车姿势帅吧为了防止出血，脚要抬高	粗略看胎压表亮了，有空去检查一下胎压
要是在郑州打该多好啊。直奔火车站唉。有家不能回啊	呵呵呵，河南哪里都是你的家，你是河南人的骄傲！
【创意床单第二季】那些有创意的床单们，你想要哪套？	喜欢那个多手多脚的。
说好了不悲伤，可我还是想悲伤•••	不用悲伤，因为墨墨会一直陪着我们，
苹果产品每日报价10月12日iPhone5价格大降：alink	请问怎么辨别iphone数据线真假
#好吃的#妈妈不在家，我做的豆腐和虾皮青菜，哈哈哈，好吃得很！	还蛮好看的样子，杰思好能干！
生日蜡烛升级版。这个可以有！（动态图！）	刚开始还挺新奇，现在不想用了
盘点历史上最经典的吻Let'sKISSing	的确是高，不一般的水平是说不出这话的，任总
#黑莓星期五#儿童节快乐哟！大孩子们打算怎么过节呢？	Instagram为什么不支持黑莓下载？！
藏旅13：丰富漂亮的西安晚餐！	看见你现在心情好点，我也开心！祝福你。
做人低调很重要，该开口时就开口！	我想低调可嘴巴没那么大
令老师头痛的数学答案。	这个小盆友很有绘画天赋嘛。哈哈哈！
交话费的时候才发现原来我的废话是那么的值钱。(转)	嘿嘿都是别人打电话给我还不要钱哟西
苹果公司到底多有钱？看完图你就知道了……	钱的总数干嘛一直变
经历了无数个失眠和好梦，就这样，我们长大了。	互粉啦！今日互粉爆粉！
今天晚上我将偷走你所有的假期作业	真的啊！那太感谢了！快来偷吧！
Mac用户、Windows用户和Linux用户眼中的对方。	哈哈，看样子我是windows用户啦
当时你看到朱茵的这个眼神，有没有被秒杀？【转】	看《大话西游》，感动的哭了
Iphone打字害死人啊！刚才打nokidding，都发出去了发现是nokissing。	喜欢你的新作（心术）
日本井盖设计欣赏，设计让城市变得更有趣，童鞋们快来欣赏吧。	哈哈。我家门口的基本上都是樱花。大大小小五步一花。
30年代纳粹德国纪实，这彩色影像实在是太珍贵了alink	好象在哪里见过，不只一次。
有些事情我不看透，不是我太笨，只是我太善良。——小丸子.	O(∩_∩)O哈哈哈。笑我笨的人，快来看看真相吧。
【#我是歌手#决赛阵容】天天向上特辑开始啦，大家打开电视哦！	为什么没有林志炫？
第一次见到有这么象狗的笑容，可爱的金毛有没有？	这个形容好犀利啊、
对比一下你就知道啥叫温柔了。「转」	很明显你是属于下者！
2013高考负分作文：《梦》（转载）	中国的作文是只可以歌颂祖国滴
中医药将升为国家战略非常正确！	能赚钱到是真的，研发费木有啊！都他妈是纯利润！哈哈哈哈
#如果在宁波拥有爱情#新鲜出街，看见宁波人的浪漫	落版超给力，爱情更美好！
其实。。我也没有。。只是。。（呵呵，呵呵）而已。	其实我的口算没那么差，只是十以内的算不出来而已。
You'renotalone！你永远不会一个人！	我觉得应该是“你不会永远一个人！”
不知道易思玲玩CS会是什么水平	拿狙才打十米啊弱爆了！
香港真美，人生享受尽在此。	吓死了，仔细看原来有窗户的，额。小龙好Q啊。
毛泽东逝世20周年毛新宇纪念题字。	龟孙子。气死你爷爷。你爷爷是写千里江山万里雪飘的。
#读图#三种最让强迫症患者抓狂的图标！看看你最受不了哪一个。	貌似……这三个我都无法容忍
诗歌：《在夏天时想起秋天》。夏天时贴过一次，现在应该再贴。	在冬天时迎接春天。
在海底捞吃火锅，拉面师傅好飘逸的功夫。	勾起了我对海底捞的美好回忆。
英国媒体选出的15件超级爽的事情，你们感受感受。	知道最后才发现被耍了啊啊啊！
刘谦这个小骚货。容嬷嬷在后面笑得好祥和！	小针儿已经捏手里了
是啊，长得丑的人怎么混？	女人的外表还是蛮重要的。
你丫拿个诺基亚还想泡妞一一一一今日被震到的一句	拿最贵那部，怕妞不识货而已
吃面条的新方法，这个可以有！（转）	被香肠裹住的部分根部数步了，不实用啊。
春雪燕园喵。多可爱！图via人人网友段炼	湖边也有啊，好肥的猫
湘西边城，美丽凤凰，灵魂栖息地。	看到这图，心又发痒了！
十一假期还有一天就结束了，大伙儿，失落不？	我今天就开始上班咯，还要持续10天的努力，哎，何止失落
【每日一萌图】请叫我犀利姐！图片来自animalworld.tumblr.com	楼主每天的萌图能大点吗？我好做桌面壁纸用
我们准备好啦，期待和诸位一起揭晓每个奖项的最终提名💁🎁	大美女，工作顺利！
我正在扮演一具尸体。	哈！好一张狗皮褥子！
没有链条的折叠自行车，帅爆了！	帅你妹啊，踩十圈才走一圈。
期待+支持小综的国民英雄。#4今晚comingup。	好兄弟相挺，我们也挺你，阿用加油！
各种身份的睡姿💤💤好形象哦😊	屈指可数的好创意微博
发表了博文《浅草寺里》-alink	终于有点日本的真实面貌
老胡蜜今晚下厨咯，我爱的意大利面	不知这位湖蜜在虎扑id是啥。
小时候玩过这个神器的，请自觉转发……（估计90后没见过）	见过，不过我们都是自制
逝去的记忆：1949年全国铁路网示意图	49年就有沟海线了吗？六十多年了，东北铁路网没什么变化。
骂人多没素质啊，以后学着点，硼化硫！	学校教会了你知识，你却用来骂人，可悲
早市儿观点：看图说话••••••	让我们跟上春的步伐
出发去西湖，划船去喽。💛💛💛💛💛	注意休息吖！自带熊猫眼外出危险吶！
＂我们如何走到了这一步？＂	因为看了你的人生需要揭穿，整天使劲瞎折腾
越狱，翻墙……还有什么？	米帅说救爱人、兄弟、侄儿，美剧越狱第二季快出来了。
保加利亚总理送给普京保加利亚牧羊犬。好萌。「图转」	古代送美女，当代赠萌宠。
到处都被金钱统治着。（梭罗）	天下熙熙皆为利来，天下攘攘皆为利往
资料整理就是个体力活啊。何况是快1PB的数据了。	最近国内的片子多，大多是公务员级别的，把岛国的删了吧
你上学的时候用课桌打过乒乓球吗？小编干过这事儿--……	还用球拍啊，我们那时候用黑板擦的
【各种银行卡收费情况】你需要知道的生活小常识！	微博内容不实，鉴定完毕。
关于青岛城市规划的一段采访。	这段采访肯定不敢在青岛播
这药真太难喝了。我得装睡鸟！	惹惹！那鬼马的小眼神儿。
#真.男人#姑娘，你太过了。（转）	电影里怎么没这段。
虽说这是个充满竞争的社会，但朋友碗里的饭还是不要惦记。	朋友毕竟是朋友，因为朋友很重要。
【最新男人分布图】唉。不禁要感叹，这年头好男人都有男朋友了	还是第一次爱的人好，这些男的太不靠谱了
活了卅几岁还没住过院。这个生日过得有意义。	怎么了这是。注意身体哈。
据说每个人身边都有一个吃货。你第一个想到了谁？	嘎，想到了我特喜欢的好朋友、经常一起吃饭聊天、唱歌巨好的那个
#图读生灵#——油价上涨与飞机坠毁。（资料来源：李铁根）	不仅仅和飞机失事有关，还和地震有很大关联哦！
人生中10件无能为力的事	人生最无能的事是：天气陛下对自然和人类无情的摧残与掳掠！
陪伴，就是不管你需不需要，我一直都在。	你会一直都在我身边默默的陪伴着我吗？是一直。不是一时。
你买过哪些东西，会因为提升生活品质和幸福感而觉得相见恨晚？	电动牙刷，飞利浦剃毛器，crocs凉鞋
“姐姐，就给我吃一口呗？”“傻弟弟，吃冰激凌很容易胖的！”	我似乎看到了蜡笔小新和加菲猫了
一个家庭幸不幸福，80%取决于女主人。#情感智慧#	这样的女人太圣母了，本人是做不到哦。
两岁大的黑猩猩""DoDo""给60天大的小老虎""Aorn""喂牛奶。好有爱！	小老虎长大了还能躺着猩猩旁边那才是大爱
夜里路过这家理发店，你敢进么？！	呵呵，挺个性的，这那是理发啊，简直是要命啊！
这样洗手洗得干净吗？！？(°_°)	一边洗一边谂到D咩野呢
上次偷猫粮就算了！这次居然把别人家的孩子拐回来了！	你确定这俩不是来洞房的么！
莎士比亚兄弟四人都睡在这么一张一米宽的小床上	我想生活给了莎士比亚创作的灵感。
我就是那种别人给点温暖，就能感动好久的人（转）	我就是那种别人给点温暖，就能感动好久的人
我们身处数据海啸的时代.传统营销已不复存在。	“传统营销以不复存在”
从医生那里得到了一种奇怪的药	这是用来治疗神经损伤的，我亲戚有用过
早上起来，发现土耳其竟然地震了。祈祷怡情一切安好。	呀不关注实时新闻啊
如果明早醒来，你能拥有一种超能力，你希望是什么？	可以再拥有两个能力的能力，
重庆市动物园一只百天的熊猫宝宝。巨萌！	第1000条微博，转发一个萌物吧，国宝宝宝六一儿童节快乐呀！
听说这是最新的奥特曼。（转）	左肩上的那个盔甲一样的东西仔细一看原来是个奥特曼妹子
红楼梦不愧是四大名著之首，绝了。	四大名著，不是浪得虚名
Google员工爆出Play商店新版截图。viatechnobaffaloalink	图标设计的不好看，其他都不错
只有我觉得彭佳慧的两首完爆羽泉么。	-你不是一个人在战斗！
试一张QING的照片上传alink	什么时候有手机客户端？
Tumblr回复系列：喵你在干什末你又不是毛巾	我是好人我是好人我是好人我是好人我是好人
所以说，太瘦的女孩不容易得到爱情。	丘比特就不能飞近点咩？！
减肥利器，吃货胖纸们可以试一下！	过滤小肉，吃大肉。
上海好大。比杭州还大。我今年是第一次到上海吧？	哈哈上海欢迎你在哪个区
""史上最牛胶布""诞生：用胶布固定断裂电线杆alink	没有钢线拉着肯定出事！查查谁的包区，严肃处理！
我的人生目标：吃好睡好没烦恼。	还真是我现在的人生目标
曼联皇马欧冠决战，3点45起不来怎么办？闹钟？不大管事。	必须熬夜。两罐红牛已经准备好了！
试试你的眼力。你用多久能找到“8”……alink	额，我真的发誓，十秒不到…
发扬狗仔精神，柴静在签新书《看见》。	小戴老师记得那啥哈！谢啦
价值7000美金的便携式超声波扫描仪，可连接各类智能手机。	从定位上看应该主打普通家用，那定价是不是太贵了
我以为我回到了18岁	把4SP了。只看图会有人信你刚18岁不久。
加利亚尼：蒙托利沃是米兰的新队长，他是非卖品！	你们这些记者，太navie。家兔说的话还能信吗？
速报！向井理和北川景子宣布结婚！via：新世界日语	真的假的但是刚上日本雅虎看了下完全没消息啊。(⊙o⊙)？
一切都是假象。经典错觉大集锦。看个过瘾！alink	睇紧哩条片噶时候、心入边充满疑惑、一直喺度讲“点解噶？”
脸盲症转入晚期的重要标志是你开始分不清梁朝伟和奥巴马。	这是真的病入膏肓了…
#随手拍#明天带这个帽子上街。	明天准备去骂大街？
美女们注意，这个一定要小心。指甲油有时可以很可怕啊。	闻起来就是天那水。
从18岁到38岁，最美的20年，女人重要的十七步！	女人最重要的十七步。
尚未有人能在10秒钟内一字不差的念完，不信，你可以试试。	最后一个错左。哈哈…
写给最后一任男朋友的一段话。	写给最后一任男朋友的一段话。
连载（一）：张鹤慈来到新浪微博始末（长微博）	对于真民主、真自由的人士，我表示尊重。
作为枪迷一枚，表示如果阿森纳要是能逆转，我就去裸奔！	如果逆转了，不要关门在房间了裸奔就行了。
试试你的眼力。你用多久能找到8。（转）	没超过十秒。真心没骗人。
老太太很有理论自信。分享图片alink	光着腚推磨------转着圈丢人。
生活就像一盒巧克力，我永远不知道多吃一颗我能长胖多少斤。	割肉是女人一生日夜反复的话题
一生只谈三次恋爱最好：一次懵懂，一次刻骨，一次一生。	一次懵懂、一次刻骨、一次一生
小家嫂表这么痛苦，我们剔牙哥蛮帅的其实……	这副口脸，我都笑抽了
见过冒绿光的咪咪没？原图没做过手脚。	点解甘神奇？求专家解释。
我对这个社会终于有贡献了。眼角带泪轻快起舞。	我希望有个如你一般的人加油，早点给梅茜找个老妈
【进击的西瓜】哈哈太能折腾了。呼叫亚洲保护西瓜协会！（转）	严正谴责此类伤瓜者！
帮主人看车的狗狗，抓住自行车一动不动！又好笑又有爱。（转）	跟人接触多了。就会越发的觉得狗的忠诚度极高！
高迪造了一辈子的圣家族教堂与他的照片#美图秀秀iPhone版#	蛮爷爷去巴萨罗那了。羡慕。
今天第一次攀岩，好难啊，还差点冻死。	卧槽。你是美女！果断取关！
字幕组真的是太有才了。╮(╯_╰)╭	字幕组！我爱你们。
学好一句话，走遍天下都不怕！（via暴走漫画）	IT狂人。＂Haveyoutriedturningitoffandonagain？""
总被自己吃东西时的亲民形象感动和惊艳到。#永远都在吃#	对吃是在是无能为力啊
中国经济的此次下滑不是周期性的。	哦？那是什么性的？
看看幽默交警如何教育90后非主流alink	那个肥猪流是男的女的都不清楚
这不是春运，这是早上七点的北京儿童医院	什么时间去都这样！
终于又能吃到成都菜了	跪求老刘的尾巴我也是盖世3尾巴是安卓客户端
蒋采苹先生画作欣赏《夜荷》	这个蓝色妖！喜欢！
自助者天助之，自弃者天弃之。晚安。	令我不安的明天，希望一切顺利吧！睡去。
今天空气质量，北京空气达标。	北京的空气实在是太糟糕了。跟瓦力里的一样
猜猜看在干嘛？知情者禁言哈	我也是猜是“面壁思过”。
当你想吃垃圾食品的时候，就看看这张照片。	当嘴馋的时候，看这个！
人生该做的六件事。（图viack101.com）	卧槽，真够2的。楼主动漫迷吧。
一只有洁癖、有生活态度、有原则的喵星人！	好一只爱干净的小猫咪。
小偷不可怕，就怕小偷有技术！（转）	好好玩啊怎么做出来的图木哈哈
今晚简单一点，来一碗烧鹅濑粉，行不？	看起来不错吃。哪里呀，推荐下呗。每天吃饭还挺愁的
小丸子式生活，其实都是我们现实中的生活本色。	生活，感慨一下……
一位妹子和男神的对话……看到后面有点感人！「转」	这不是那篇文章的简洁版吗，，，无鸟
【史蒂夫·乔布斯1955-2011】世界因你无限美好alink	你刷了一上午我都烦了，适可而止吧
带还是不带呢？总决赛第七场预告：alink	能赢带不带都不是问题
唐代完整的化妆步骤。	老实说，我觉得蛮好看呢。
神一样的印度电影，你们随意感受一下。	比我们国家的手撕鬼子，强多了
我这人，最大的美德，就是从不跟没素质的人讲什么素质。	这年头，就得学会不要脸
春姑娘。算了不说了。今天聊：睡沙发。在线收听：alink	春节回家还睡了次沙发，看电视睡着了就直接睡那了。
该吃饭时不吃饭，会找不着对象的。	吃的不是你的饭，一样找不到对象。
#chunwan#不愧是台柱啊！主持人里就他能单独上台唱歌吧！	原来是老白唱得啊！我就说汪峰怎么可能现场不走音。
Eminen颁奖给LadyGaga的惊讶表情	这位哥哥是被吓到了吗
每次找同学借作业抄，他们永远都是那句话：""我是乱写的！""	==、其实都有绞尽脑汁认真奋斗。
这样的饼干你们舍得吃吗？	/咳咳。好可爱。肿么舍得吃哇。
今天就先画一幅素描吧，网友们看看，能及格吗？	脸型很难画，标准的不规则脸，有点像土豆
快到六一了，是时候把手里的杜蕾斯给大家分分了。	你的数量也够多的。
哎哟，饿坏了，好吃好吃。我一边吃他们一边笑我。	介是到哪了呀？往察隅还是盐井呢？
今天北京的空气质量很满意，出来走走吧。	天还没亮，走在黑暗里的感觉会好吗？
奶爸的父爱又泛滥了。想77了吧	一手的纹身，满脸的大胡子，估计看到哭了……
【开心一刻】大哥你到底要作甚？	后来呢？我清晰的看到最后裁判举起了手。
属于狮子座的蛋糕，喜欢吗？	提早祝我儿童节大乐.嘻嘻
让python的编码给整崩溃了	哈哈，肯定有点不习惯。
爱像水墨青花，何惧刹那芳华！	无赏何用？难如真切。
同样是开会，中国、美国、英国，仰视、环视、俯视。	你这能说明什么？你想说什么？
【趣漫画】我靠，这几个人怎么这么淡定！擦……图片来自imgur	在里面拍照的是。？
我知道自己在干嘛⋯拼了⋯累！救我⋯	加油，少喝点酒……别坏了身体
建议每个女孩都读读《他--没那么喜欢你》。「转」	他其实没有那么喜欢你！含泪奔跑，是否会跌倒？
停车，车位，有了它神马都是浮云。	这不是鸟山明的七龙珠里面的胶囊嘛
人生就像愤怒的小鸟，当你失败时，总有几只猪在笑。	(⊙o⊙)啊！第12关老是过不了，极度抓狂。
苹果公司到底多有钱？看完图你就知道了……转	第二个，最后一个。
如果。将会。人生哪有那么多的如果。	咋了姐……想我了咋地？
小桥流水般的洗手池，太喜欢了！	挺不错，就是太浪费了，求关注啊，互粉
收拾东西看到很多年前在曼谷买的一个Tshirt	哈。这就是人类的进化
世界末日，未是末日；末日未日，方是末日——禅师赠青年偈子	never区分的了这两个字
六一儿童节只有手机相陪的，请！举！手！	躺在床上，抬脚。戳中泪点
风行猫咪界的睡姿-五体投地式，可爱滴猫咪！	哈哈，我家猫就这样睡过
在黑夜奔波赶路。为什么我忽而看见了一片蓝天。	最近又很忙吧，记得开心哦。
人生总苦短，倏乎又一年。秋叶落梦里，春花开眼前。	切情切景小文小画！
一阵阵地想和全世界绝交。	我一阵阵的想和全世界性交
上传了87张照片到“微相册”。alink	范范的这双鞋是啥货号啊？好。美
这张偷拍的不错，以后做事要小心，窥视无处不在	每天照顾花花草草就够忙活一阵子了
当时我就震惊了！你想过用Facetime监视厨房炖汤进展吗？！	谁想出来的好主意！如果能把屏幕关了就更好了，当监控。
看看人家东北是怎么卖冰棍的，冰箱神马的都弱爆了。	。我怎么从没发现是这样的？
网友总结暑期必备神器。	啊啊啊妈妈大人的世界好可怕，我要回天堂。！
别在他开车时给他打电话！	Hey。buddy，drivingcarefully。
你的旅行，还缺什么，为啥还不出发？（转）	还缺钱。还有一条刚起步的求学路。
老的时候。开间花店、书店、咖啡店一体的店吧。	我也有一个这样的梦想。
叶子上的雕刻艺术，这力量的拿捏，，，	如果不是PS的话，真美！
今天整理旧物，发现十年前的照片。十年之前……（二）	这些我们要留着，放在某个地方保存起来
没有这锅＂砂锅馄饨鸡＂的冬夜，最难将息	照您这吃法，没有哪一夜是难将息的。
千言万语尽在这一个字中。（转）	千言万语汇成一个字
超有爱的哆啦A梦饼干，无论是盒子还是饼干都萌S了有木有！	这个这个，我吃过，盒子和袋子都留着呢
情人节和家人在一起祝愿有情人终成眷属！	巴哥你是博乐的吧，，，？
丽江夜景，一个让你来了就不想离开的古城。	能说出这话的基本都是没去过的。
阿朵《男人装》重口味的伤员造型。（来源：新浪娱乐）	神马体位？浮想联翩中。
这个点往家走，我是有多爱工作？	法妈辛苦，咏哥也不来接一下
蜘蛛高跟鞋你敢穿吗？	这真的能穿得出去吗？
今晚算废了。再聪明理智的人，都有搞不定自己情绪的时候	尤其是在喝酒和愤怒的时候！
没有什么人能一路单纯到底，但是要记住，别忘了最初的自己。	坚决坚决不会忘记的！
这个光着身子的记者，请穿上衣服再采访！	大鹏这造型像屌丝男士啊！。
小米手机现在正式开放购买了，我的天。才十分钟。	这辈子算是等不到了！本来以为可以成为小米一族
人其实挺矛盾的。总是希望被理解，又害怕别人看穿。	说的太对啦！都是屎人些。
交完房租剩650块钱，还从来没这么窘迫过	摸摸，看来是找下了，所以还是别记得买吉他了吧
胸部创伤……这个，是不是太那个啥了……	膜拜神图。内外科的导图还真的要很神才行
移动高管告诉你什么叫真正的中国移动！	有意让他移动的吧！
许多事情，竭尽全力，然后听天由命！	尽人事，听天命，人在做，天在看。
十五部心理学高情商好电影，你看过几部？	那十五部阿？看不清
就是不让对面拍照那小子满意！	你家对面真是无穷无尽的折腾
五年没有去重庆了，今年终于要去了！	时机不错，可以去了。
新鲜的葵花籽，舍不得吃呢。	看的我浑身起鸡皮疙瘩我有密集恐惧症
JUMP史上漫画家休刊次数，富坚义博YOUSEESEEYOU！	富坚的话应该列的是更新数XD
乔布斯的墓碑横空出世	陈江华你老实告诉我，这个微博是不是你女人在养了现在？
一堆人等拍戏等到累了，今天拍摄会拍到天荒地老…	辛苦了。等到都石化了。
据说……这是世界上第一台照相机。	用世界第二台照相机拍的，或者这就是个模型
住五星饭店吃方便面，这是一种什么样的人生境界？	因为房钱不是自己付的
超简单的全息投影教程，好酷！「转」	那个透明材料在哪里可以买的到，跪求大神告诉
PVP怎么了？没看懂。请有问题玩家朋友跟贴回复。	大师按了一下午才打了几场提示老找不到匹配战斗力对手求修改
槽！这速度真快。就抢完了。耍我？！	大家都在等确认按钮你就进去了进去又没票了
终于晓得为啥老是睡那么晚了。	终于知道自己为什么总是睡那么晚。
产品和技术是不应该有隔阂的，只有这样才能搞出伟大的产品！	这图？不懂，谁解释下
人没有捍卫自己观点的义务。	这话说的很深刻。有理……
【欧文】一定是我打开图片的方式不对好久不见，欧文。	这是要演西部片么。
每个瓶子映射的风景竟如此不同，好神奇！	关键在于每个人的心情，所见感受也不同！
路过北京轻轨桥，看到有人在修，是防患于未然吧？	中国的建筑哪有什么安全，不是豆腐渣工程都是一流的工程！
大家都不要吃松子榛子了！一定要看！	大家都不要吃松子榛子了！一定要看！
这才是真正的美人鱼礼服吧！性感呀！	这条金鱼谁来喂？💃🌟😚
你必须很努力，才能做到看起来毫不费力。	必须很努力，才能做到看起来毫不费力。必须···很努力。
让我轻轻地告诉你……摄于茂德公草堂	番禺金山大道那个吗？
#万人携手同行上赛#两位同台，尖叫吧！	靠！都是偶像啊……
毕业前，一定要和闺蜜死党们拍一张这样的照片！	怎么办，都毕业了这么多次毕业了这么久了
世间最痛苦的莫过于此。	啊啊啊！我最喜欢这种猫了。\(≧▽≦)/。
短片《混乱三千年》！在2分30秒处，亮了！alink	这个短片拍出了人类历史的壮阔
请不要走应急车道，否则……	急毛啊，卡蛋了吧。
【心理图片】总有一个傻比，无条件对你好。	其实傻逼也有傻逼的幸福。
会抽烟的男生都看看！烟没有抽得这么潇洒，就戒了吧！	抽烟的男人，找抽呢？！老婆抽！以后你们就懂啦
这里有没有一首歌，你最怕听到？转	我看到了N多周杰伦写的歌、、、
准到让你惊叫！一分钟内看到的前三个词可能就是你的人生观。	忠义，大方，完美。怎么感觉像关二哥啊？
不相信自己眼睛了，天太美了	这几天好多人都不相信！
最近严打，只有看着下面的狗狗玩了。	小哈都这样吗？我家那只也这德性
你听过乌龟爱爱的声音吗！我只能说很像人！alink	。想起独裁者里面的一段戏，母的没反应啊
如果你还记得它们，你孩子都会打酱油了。	我记得但没小孩是我太老还是小孩来的太晚
想去理发，又赖在床上不想动，谁来踢我一脚！	自己拿剪刀剪一撮或一次性剃光
哇我们这里现在就开始下大雪。	顶礼师父！我的心已经回来了，四川是我的故乡。
全场比赛结束。乌迪内斯2-1米兰。	出售球队吧，这样下去迟早保级。
分享一下，这应该是第一个十三钗的周刊封面。	我真是可以给出10分的电影吧····
幸福，有时就是这么简单…….喜欢就拿走吧。很感人的图图。	简单的幸福，遥远的幸福。
有一种基情叫黄晓明罗嘉良	我最喜欢的就是刘诗诗了，长的漂亮
家中水仙盛开，喜迎立春。	终于看到开花的水仙了。还一下子开了这么多。
浪漫而成功的求婚，哈哈	恭喜啊，太浪漫了！
今天出行，有种大雾天在冰面上溜冰的感觉。	买了你的三部曲，一部不如一部，浪费我那么多钱，求关注来补偿
我不太肯定我的方向，但是我希望自己能走的远一点。	希望自己能走远一点，远方有多远就走多远
校长开房找我，放过小学生！	应该发送中1办转给习主席看看。
某小孩说，我最喜欢这张！	果真很可爱的样子。
满足其中8条，就证明你很幸福。	那我不是幸福的一塌糊涂。
20年了，他永远31岁，而我们却都老了。#怀念家驹#	最好的归宿，害怕看见他落寞
需要大把时间，和一张大书桌。	写书在于先构思，一动笔就是那么运动中写作！
爱丽斯漫游仙境！当日常用品被放大一百倍之后……（转）	呵呵，好大的鸭子……
映秀的漩口中学，现在已经是景区了	景区？心中的伤疤就算愈合了，也不会美丽依旧吧！
#萌宠一刻#跳水有什么好看的，看我给你跳一个！	你好，话题#萌宠一刻#暂无主持人，赶快去抢吧！alink
整天抽烟的朋友，知道怎么做了？	上一天班，减壽8小时。
半场结束，美国59-58西班牙。科比第二节没有得分。	我科为什么半场回更衣室的时候是一个人走的
没觉得太好看。别拍砖。	因为你挑到哈林组的看了
男人毕业后的5个阶段，你处于哪一个。(插画家园)	恩，目前状况尚可，允许再壮一点，继续保持。
我怎么能这么准啊，变态准。哇咔咔咔	上一场库里不准了，是不是被你害的。
视频：PickRide乐搭：为未来的中国创新者扫清道路alink	已经下载了支持原创禁止山寨
豆腐皮卷大葱，哈尔滨红肠，还别说，倍儿好吃。	怪不得晚上车厢重口味。
重口味漫画，你们准备好被挖了吗？	我开始以为是豌豆。好邪恶啊
#iPhone问题#哪里的苹果#iPhone#手机最便宜？alink	去香港买，我在香港买的苹果532G只5K多
据说最先看到的单词就是显示你自己的单词！你看到的是？「转」	一个都没看到怎么办
德国马格德堡市水桥，绝了。	德国人哟，有创意，有技术，有执行力。
伯纳乌球场，和静待比赛的草坪。	静静地等待美妙时刻的到来。
伦敦今天天气很好，阳光仿佛灿烂到了心里我在:alink	我又开始相信爱情了。
“元芳，你怎么看？”“大人，此事背后一定有个天大的秘密。”	“大人，此事背后一定有个天大的秘密。”
什么是幸福？家里没病人，牢里没亲人。	说到牢里，您的X氏女系列还没出新的啊，我可一直在等
石头上开出的花朵，这些花儿好美呀！	我倒觉得可以用来玩连连看
#男人帮#首映结束了，希望大家从明天开始收看《男人帮》。	绝对看，都是实力派，肯定好看。
高考作文中的雷人语句出现了，艾玛，要笑死去。	认真读完每一条真是才人辈出的时代啊
新闻要放在一起看：桥坍了，塔也快要倒了。	宝塔未能镇河妖，该倒！
这认证信息亮爆了啊。	不得不说真是碉堡了。
感受性弱一点也许更会简单快乐。	或者说追求简单就是为了追求快乐。
三观尽毁！白读了18年的书啊！转	白读了18年的书啊！
高考，你妈逼你刺字了吗？！	十年寒窗苦读只为这三天一搏，高考的童鞋们，加油！
这不是宝马，这是永久。	给我来一场这样的爱恋吧
""你存在，我深深的脑海里。""	车子很帅气…和人一样帅气。
脸书上看到的，大家在玩这个游戏，这是谁呢。	文托拉，我已经找到原图啦
我爱你，那已经是去年的事儿。	我爱你，已是前几年的事儿！
#看图猜迷#猜两部今年最火的电影	亚马逊送的小铁盒给我发了个最难看的！小编能补偿不！
仼小毛新书出版，61岁生日，又是三八。几喜临门，不知哪个为主。	任总过个生日，【得收多少玫瑰花啊？】
一张图告诉你为什么我国国情不适合跑酷！alink	哈哈不是跑酷是跑哭。
阳光穿过树林产生的”丁达尔效应“，简直是美透了！	有种众神之巅的感觉呐
#郑在晒午餐#吃过午饭了？公款私款？	老郑每次的饭菜都很健康啊！
起床，看着窗外发一会呆……	hugo。你貌似住天上人间吖。呢个view.
近期枕边书。死前唯愿书作伴，身后无求忆于人。	近代史就别看了，看了伤心！还不如晚晴呢。
早上把iPhone4忘车里，刚才去拿就成这样了。	真的，上周六手机忘在车里，等发现时就这样了。
一到六一，哥的节日，到处是气球和玩具，哥就激动的老泪纵横	致我们终将逝去的青春。
雨后感慨，写多了。😝😝😝😝	果断取消关注9万起和我等P民没任何关系
慈禧太后作品《紫藤花卉》	红花越看越像罂粟。
《穹顶之下》（UndertheDome）公布动漫大会海报！当然是半头牛！	第一集印象最深刻的就是这头牛了
今年任意球员市场的一条大鱼，适合我雷不？	假如条件允许，绿军最有可能引援他
时间告诉我，无理取闹的年龄过了，该懂事了。	怎么老有人刷屏！没素质！
犯错误的时候，记得给世界抛一个无辜的小眼神儿。	无辜最让人生气不下
体育老师病假，物理老师代课。	这个实验的学名叫什么来着？什么守恒什么不守恒？
最具中国特色的星巴克咖啡。	三坊七巷里屈臣氏和麦当劳也这风格
曝航班延误原因：载官商航班插队alink	多乘飞机就不怕掉下来？
虽然我是说要减肥，但没说要节食呀！	我家的猫怎么没那么乖
这就是：公平与正义。晚安。	人人平等关注弱者··
长沙小饭馆餐桌上的基本配置。	辣椒适合炎热潮湿的地区，在北方唯一的后果就是上火！
哎呀，我今晚去吃点狗肉，朝鲜狗肉馆。	更正：应该是反对城市遛狗，应该圈养而且不要扰民！
男朋友和动漫你觉得哪个重要，这可真是个问题。	对于这位妹子来讲一点都不是问题，因为没有男朋友
钟山，眺南京。无风雨，不苍黄。	天朝哪个城市的空气都是这个样子
女神拒绝他，只用了一个分号！	女神不会轻易让屌丝逆袭滴！
如此蓝天白云的日子最适合睡觉了	萌死了！喵星人也睡枕头。
究竟白宫网站上WethePeople指的是谁呢？来看看这篇文章！	额……应该会懂我说的意思吧？
被互联网覆盖的真实世界。（转）是这样么。	如此重要的公厕竟然没有。
你的心里有一面墙，推开就能看见天堂。	推开墙门，向前！会豁然开朗，看开许多！
人的眼睛有5.76亿像素但却终究看不懂人心	废话，又不是X光透视眼。
“给予比别人期望的更多，就是快乐。”（《飞鸟集》）晚安。	这快乐不是赠予，是获得，获得一种透彻地，持久地快乐。
北京的童鞋们，今天北京的天气好吗？	天气倒是挺好的，就是气温低，时不时的刮风！
黄绮珊是在表演二胡吗？	哦？你也看我是歌手吗呀！
88秒内转发，拍拍手，霉运走！	霉运，快走快走！好运快来，快来！
儿子，走。别和这傻孩子玩！（转）	好有趣，动作都是跟人一样
拒说好女朋友的标准。比男朋友轻50斤，你达到了吗？	好男人的标准要比女人重八十斤…………
只有中国女人才能穿的出的性感——旗袍	夏天穿有点热呢，呵呵
如果你知道这是什么，你已经老了。	尼玛这一看就是4合1啊
台北利达片厂.mv拍摄中.好姊妹来探班，开心ing。	来晚了，亚亚姐，早安！春光明媚的早晨！
【北京61年来最强暴雨新闻汇总】alink	抓紧时间准备召开抢险救灾表彰大会
【非幽默】中国足球崛起看来只需一招：高考考足球！	这真可以实行··。··。·
进球以后的巴神低头不语，和罚丢点球的巴乔一样忧郁。	从犹豫王子到忧郁王子，不易。
中国蔬菜批发价格4周上涨15.4%食品通胀初现alink	除了房子，老百姓对物价最强烈的感受，基本来源于菜市场。
这位朋友你去赞别人好吗	不要这样！人家在敷面膜！
薛飞老师到馆，二十多年来，一直觉他才是中国好声音。	是那个黑小伙吗？真看不出来了。
头疼，感觉选谁都打不过他	哈哈，佩佩是有点过了，多少摄像头对着你呢，控制不了自己的情绪.
Takami皇家新娘婚纱礼服，漂亮的童话公主风格，高贵优雅。	模特好美腻好乖巧！喜欢
……对不起我又崩坏了。原图在前一条围脖……	我很想问，男的女的？看不出来啊
微软也要出智能手表了，不过还没出。就被黑哭了。	切，就微软那电源管理？
人身安全已受到威胁，谢谢大家关注。	这是举报那坏蛋的记者！你点击看看就知道了。
我压的是巴西，难得的球迷还能赢…估计没问题了	hah，荷兰队胜利在望。
农夫山泉右边是假的，大家转发告诉身边的朋友。	农夫山泉已经辟谣，两者都是真的。
偶然看到这张照片大家知道是谁吗？	左边是你，右边是你基友
今天北京风和日丽。打了会儿黄昏篮球。	看上去郑老师好高啊
#没品新闻#遥知不是雪，为有暗香来。	脚臭分了还好，因为用的牙膏牌子不一样分的才牛B
哪个二货想出来的馊主意。哈哈哈哈	早上笑一笑，一天很美好。
#我洗脸用手#第一次听说用毛巾洗脸，毛巾不是擦脸吗。	第一次听说用手洗脸的。
新闻民工收到这个，泪流满面	就算不遮打过去也不可能有人！
江苏！山东！请严防“达维”！	“达维”将可能成为第六个正面袭击江苏的台风
我所不知道的广电总局，#剪刀手的自述#。「转」	引用某句万能语“贱人就是矫情”。以上
主人，剩下比赛的就让我替你去完成吧！（转）	笑岔气了。自行车也有定速巡航呀
超小户型可以参考参考哦。	自己的空间，小小的也窝心。！
仍在使用的孟买百年火车站。	只有天朝子民是巨能钙……
今儿买的鸡蛋，瞧这蛋黄又大又漂亮，做蛋糕一准好吃	这是要做什么，很好奇。
#变态辣椒时政漫画#这回真的豁出去齐B裸奔了	果然八卦容易抢新闻！
一张狠图告诉你什么才是——坚持就是胜利！转	真笨，要是我就坐在树上等
母亲的八个谎言……你信吗？	要经常对妈妈说：“我爱你”
下午三点半绕城公路居然堵车疯了	好好打，季后赛看你的！
我在北京。天阴沉到黑，要哭了。	我在成都，太阳无比大。
小宾剪完毛回来了好。可。爱。喔	和我家狗狗一模一样
被赞为「表情女帝大人」的日本四岁女孩Aries，超级可爱又无厘头	女谐星都不怎么漂亮。
为什么那么多人不再信任铁道部？alink	俺最信任楼下小卖部
好可爱的肉夹馍，你hold住了吗？	好可爱的伊利莎白！
【重名数量排行榜仔细看看你中枪了没有！】alink	这里面好多好多我的同学、同事、学生……
0812话题：你有没有被利用过？你是怎么想的？	有，不过被利用好歹说明还有被利用的价值
缘起，在人群中，我看见你。缘灭，我看见你，在人群中。	缘起，擦肩而立。缘落，擦肩而过。
一张图告诉你，12星座人生最快乐的事！	怎么次次处女都纠结
银川市工信局3月20日综制宣传	支持一下感觉挺不错的
又见逆天小学题。（转）	就48啊····不过不知道我小学的时候要想多久
迟到的祝福---教师节快乐，所有的教练节日快乐！	刚才看到快男李炜一身行头和你好像。想小鲍小鲍到哈哈。
3月5日，学雷锋纪念日，各地“学雷锋”百态。	雷锋被恶搞了，雷锋在地下也不得安宁！
决赛，是两个队的事儿，也是两个人的事儿。	我认为是伊涅斯塔vs皮尔洛。
你敢摸我的脚，我也摸你一下。	呵呵呵！养狗应当如此！
2011年3月搞笑大集锦！请自备氧气筒防止笑死……alink	笑泥MB啊，这么蛋疼的
有同感的童鞋自觉举手！	同时也讨厌下护照上的
看了不少对ios7的吐槽，但我相信大家还是必须要更新的。	ios7增加了SpriteKit，对cocos2d-iphone引擎影响较大
【每日一萌图】猫猫都是一样的，一样的……图片来自imgur	嗯哪。大猫猫尤其可爱。
一觉醒来发现还有几个小时可以睡，你会不会觉得格外幸福？！	一点都不幸福，可能是噩梦惊醒
张灵甫女儿张清芳、儿子张居礼。	张灵甫这脸蛋要是到现在，那得有多红？
唔哇。其实我真的挺喜欢张翰的。o(>﹏<)o。	那你喜欢郑爽吗，喜欢翰的一般都喜欢爽
你可以不喜欢，但请不要伤害！（布丁卷涂鸦日记）	应该把他们打包送到狼心狗肺星去
费雷尔职业生涯首次杀入大满贯决赛！	加油，你就差一步了！相信自己！加油大卫
送你一个小太阳，转走它，愿你的世界永远是晴天。	永远是晴天，不会晒死吗
神一样的印度电影，你们随意感受一下。	随意地感受了一下《超人》什么的都弱爆了
#高考祝福#孩子们，希望你可以用2B铅笔勾选出你牛B的人生！	祝同学，考出人生，
关于手机应用群殴这事儿，元芳，你怎么看？	呵呵，世界顿时安静了有木有…？
世界上就只有那么一个我，如果你不珍惜，也就永远错过了。	请珍惜我、在我还爱的时候
据说，喜欢腿夹被子睡觉的人，性欲强！你是吗？	这都是神马吖…喜欢夹被子的人们儿吖……咱们伤不起啊……
众人中守住嘴，慎独时守住心，草木间守住茶。	群居守住身！“共赏瀹茗图”
我去，尼玛怎么这么硬……	破冰的革命总是伴随着阵痛
最让我大射手烦心的，是游玩大计受阻！	射手真的很喜欢旅游啊。
只能选择一种，你会选什么？alink	后悔药，如果生命可以重来一次，我希望一切从零开始
我爱吃冷面，你也爱吗？	完全喜欢吃冷面唉。
时光，老了容颜，瘦了思念，葬了爱情。	时光，老了容颜，瘦了思念，葬了爱情。
1212话题：你被父母“干预”过什么事情	一直在干预，从未曾改变。一直在被阻止，从未停止。
MatthewBrodie的创意纸裙系列，俏皮可爱，奔放洒脱。	我只想知道这个穿得住吗。
不作死就不会死系列之六。	看着感觉都很疼……
这张图才是绝对的治愈系！看一次转一次！	额，，貌似的确是那么回事
上海人知道这是什么吗？	这不是瑞安李大同的桔红糕吗。
欧洲杯14场比赛过去了，0：0的比分还没有出现……	0:0这么闷的球赛也没人喜欢看吧。
在家过生日的照片，说哥眼睛小的可以统统去屎了！	脚底下绝对踩着电线头儿。
我的老红旗轿车。比用手机拍好一些吧？	没想到陈SIR也是模型迷？哈哈哈，太好了
央视：日本富士电视台派出直升机搜寻我海监船，但未找到。	让保安部来！厅长官太小，不见
520。有人是在用生命秀恩爱。你们随意感受下。	君不闻：一失足成恨千古，再回首已是百年身？
#拉手开心一笑#打着打着就忘了为什么打了。	总跟弟弟吵着吵着，忘了为什么吵了！
好男人要老得对得起妇女。	生活，活着，经历过1959的人儿，
喜欢养鱼吗？可以像这样。	稀饭啊！原来可以酱紫啊:
工作圆满完成，今天要回台湾啰！北京•再见。	一直有个疑问：宝弟不用上学吗？
准备夜战，辞职了，失业了，求保养	哈，我这周正好在北京呢，找丽人大师聊聊呀
把答案，变成你喜欢的样子。（via伟大的安妮）	把答案，变成你喜欢的样子！
为什么要关灯一小时呢？剩下57分钟做什么？	确认一下对方的性别
一篇日记，多么自律的小童鞋，让人内牛满面呀……	孩子，你太懂事了吧
今天两家中国公司IPO取消。如果我没弄错的话。	世纪佳缘结果还没出来么么？不是上了吗？
近年最喜欢的两句诗：他们摧残花朵，以为能阻止春天的到来……	他们杀掉报晓的公鸡便以为黎明不会到来！
狗宝宝的一天，太催泪了！慎入……「转」	回家后一定要抱抱巧克力，它也会寂寞的
#Lens夜话#你平常喜欢收集/珍藏________________	手写的信件和明信片木色或者木质的盒子和纸袋
难得的早饭就来这一口。	最好加碗发菜瘦肉粥，哈哈，早晨！
朋友们早上好，今天的空气质量。	潘总，这不会是世纪末的最后一次空气播报吧
主人，救救我，帮我翻下身。	乖乖，地上很冷哦！
我们来#随手拍#标语中国吧	这就是传说中的美不胜收吧？
他们真的准备去保护地球么？那个谁，要不要那么露富啊？	地球反击战比较贴切，里奥真是敢穿
买蛋糕，就是要这样买！老板一个8寸蛋糕！混合口味！	这样的混合口味的蛋糕正对味！
珍惜那个每天跟你说晚安的人。	哈哈哈，还是需要特定的，说晚安的人有时会很多很多滴。
每个人对你好，都不是义务的。所以，要珍惜每一个对你好的人。	我也会对他、她很好
四五个小时长途，实在无聊。谁来聊五毛钱的？	你绯闻女友突然发飙'向方舟子发起猛攻'你怎么看？
姥姥，就差你了……#大尸凶的漫画#	中华上下五千年，风吹雨打图个爽！
辣么辣么热，你的城市此时此刻多少度？你在干什么？	太热啦……今天是入夏以来最热的一天，有31度呢……
Imissyou，butIwon'tbotheryou.我想你，但我不会打扰你。	给自己99杯咖啡的时间
如果你知道这个游戏的话真是恭喜你了，正式加入老龄组。「转」	我没玩过这个青蛙打字过河的游戏
好像微博出了点问题，试试看发带图的微博，你们能看到吗？	怎么是一直大黄鸭啊。
熊市啊，中午来碗菜泡饭算了。	青菜剁细才好吃，太油腻偶尔吃一下很好
一大早，60后和80后又吵上了，都嚷嚷着要自由	春哥：70后在干嘛呢？
#最内涵#神奇的中文，你们感受一下	幸亏是中国人，果然博大精深、、#热门微博#alink
我和我的小伙伴都惊呆了	好牛X。电脑3D做的，太逼真了。说实话。真把我骗了。
石家庄街边某小饭馆，那威开怀畅饮，祝我生日快乐。	过生日，有好朋友在旁，不亦乐乎
第一次坐高铁，感觉不错…，晚上德州三千人在等我	不是加州吗？怎么又变德州了。
想和闺蜜一起拍一组这样的婚纱照吗？	看到这个才发现姐真Tmd前卫，2000年时就做过这事。
世界末日，未是末日；末日未日，方是末日——禅师赠青年偈子	太三俗了！开门查水表！
年末了，我很缺钱。和我一样的童鞋默默转发。	Allmoneymoneygomyhome！（不纠结于语法啊）
微信正在密谋转移淘宝天猫优质商家？	给我一个通过微信买东西的理由先。
图片解禁了，中国人的心何时解禁！	日本…永远不要对他存有任何的善意…
今天考政治一激动，差点把先锋队写成先锋盾……	老湿就该这么写哇
监控录像看到的一群非法入室者。喵星人太牛了！（转）OMG。	喵星人带着一群二货汪星人。
#没品图#太黑了……谁没获得过欧冠冠军？	这里面我厂没出力的就利物浦
看完了！准备买个陀螺去！	这个好做！买张饼，中间穿根筷子就是陀螺！
日和漫画【全集】终于可以一次笑个够啦。。alink	很好，一次过看得过瘾。
当时霍比特人的宣传海报是画上去的	有什么稀奇的以前上海马路上很多啊乡下人没见过市面
❤海浪的诱惑，是它征服了你，还是你被它征服了。	想到海啸，也许就没那么美好了··················
从大陆到香港工作的人你伤不起。	混得那么差咋不回来？没你说的那样，扯
再不开心，也要试着笑。至少你努力笑一笑就不会感到那么难过。	强颜欢笑不如不笑！
亲们……警用新装备哦，每分钟6000发哦！颤抖吧！凡人们！	加特林？！纳尼？！？！
这是北京还是北极啊？耳朵都吹没了	包总以后多吃饺子。
1967年大陆工业地图，Source：CIA点击”查看大图“	古人云：三十年河东，三十年河西。自己不努力，就会被淘汰。
比首都机场更锻炼身体的是昆明新机场。	西直门换一次地铁试试。
请记得感恩，因为没有人天生就应该对你好。	对，没有人就应该对你好！所以感恩！
看来想坑喵星人是行不通了→＿→「转」	看来想坑喵星人是行不通了→＿→
好久没有感受到落汤鸡的销魂体验。	大大要小心哦，这样很容易感冒的。保重龙体啊！
我准备做家具生意，这款产品谁看上了可以预定	真的能预定吗？价格几何？
义乌的海鲜大排档，和老同学喝酒，听歌。致我们逝去的青春！	小天天像郭沫若，微博上的郭沫若；
#随手拍#五一假期，难得有机会接触大自然！带侄女玩儿一玩儿！	你发的照片都好漂亮啊，视觉享受！
刚站在窗前，我—眼就瞧见了那个，可心的小妞。	应该拍个照！背影也行啊。
#旅途美食#大家来说说，在你的家乡，这个水果叫什么？	这个是水果么·！？！？我还以为是甜品呢。！
五种谜一样的生物。（via犯贱志）	看到了标题就知道结局了==
试了下点点，发现不会用。	我也不太会用，没互动没热情……
每个人出生的时候都是原创，可悲的是很多人渐渐都成了盗版。	媒体也是，渐渐沦为盗版
再两天就是新年了，又可以有借口大吃大喝:)	偶像，女人还是略胖点性感
解决早晨赖床的概念应用！	牛逼，专制懒虫们。
从听不腻到听不得，也就十年。唉。深表遗憾。	有时候有时候，我会相信一切有尽头。
#每日一神句#我说“千锤百炼出深山，”你接_________________？	五花大绑运青山……
爱琴海的日落，另一种颜色的浪漫。	好歹我们也是去领略过的哈哈哈
在国际睡眠日早早起床干活儿，其实本质上就是反人类和反社会！	怎么可以演得这么好
一张狠图告诉你什么叫做：坚持就是胜利！(转)	你们到底有考虑过树的感受吗？
分享了一篇文章：《冬日》	不错，绝的就是光影！
这是一封简单的小情书。	日本的三行情书吗。这样的还有很多啊。
【如何种柠檬】气味芬芳，自己种一盆吧。（几分钟网）#小知识#	春暖花开，种盆柠檬。
保护她不是你的任务，而是我的。------《碟中谍4》	保护她不是你的任务，而是我的。------《碟中谍4》
没看过含羞草害羞的童鞋点击看看.	我很色的，记得小时候把害羞草给摸死了。早上好
生活一定要五颜六色，但绝不能乱七八糟。早安。	还没有睡醒！········
【微漫画】这是最幸福的时刻！没有之一！有同感的请举手！	睡觉睡到自然醒，数钱数到手抽筋
开车到布拉格庄园来玩，让姑爷给我照一张照片，感觉不错。	关于我手的事情，麻烦杜大爷你看到后能给我回复。谢谢了！
禁止买菜刀，是为了保障大会进行重大变革。--院里传出来的消息。	更严厉的？更变态的？
主人，你整死我了，喵。「图转」	太逗了，，主淫你真素特有才勒。
实践再次证明，猫比猫，气死银。	。又想起上次少年猫的对比笑死了
你幸福吗？此时此刻，一个人喝茶，也没什么好想的，算幸福吗？	能做自己想做的事，就是幸福啊！朱老板不是嘛？
豆瓣首页的新变化alink	豆瓣为什么打不开？
到达宁波了连续三个客场真累呀！	大唐加油…现在你的发挥越来越好了…
办公室必备的喝可乐利器，夏天必备啊。	这个工具比较好，但是有点脱裤子打屁多事！
#chunwan#基佬完了就是伪娘么？	今年他的化妆比去年好点
#2012高考#【吐槽】今天上午某考场外一景。	可惜StevenJobs没能看到这一幕
开学第一天，运营商校园广告就大PK上了，太有爱了！	裸露的商业竞争，谁是最终伤害着？！
人生中10件无能为力的事。	人生中10件无能为力的事
从前有个乐队主唱他的裤子一直往下滑。	信哥爱你呦。掉裤子而已嘛
喘口气吧，还在工作台前忙碌的人们！——terra旅游创意广告	哦。对哦，喘气。直接引导去旅游，很有搅动心弦的传播能力。
Facebook今晚上市，如果是你，你会买进Facebook股票么？为什么？	美股账户空了。估计也没钱买
开始计算选票了，佛罗里达很关键，现在奥巴马领先51％	应该是说奥巴马暂时支持率51%，仅仅领先2%左右呀
姑娘，你真是条汉子。「转」	鲨鱼一会就该来了！
姗姗来迟的亨利·米勒《南回归线》《北回归线》	只要来了，就不迟。有计划出齐全套吗？
一句话不咯。高跟鞋扛桶装水的女汉子，霸气四溢(转)	90后交友加群：275072723，欢迎大家加入，非诚勿扰！
2011年中国最新恐怖巨作，超越日式泰式恐怖。	光看海报就没勇气看啊…………好可怕
不可能每天都会有高潮，这就是人生。	我很不开心，马刺要加油
【武汉公交】永恒的神话，中国F1的希望……（转帖）	武汉公交车底盘似乎不太好，乘客站不稳。
习总受到梅总的热情接待。（RIA-Novosti）	照片相当给力！其他领导们该学习一下了。
考试学生类型划分图，你是哪一型？（源自网络）	还差一种类型呢：有条不紊型。考前一天可以睡。
早上好，你跟别人打过赌吗	打过，别人生男生女，结果我输了，赔了一顿饭
还能接着坚持看下去的凯蜜，都是真爱。	我不想在回忆中度过
当你不再期待什么东西的时候，你会得到一切。	离一切相，即名诸佛
【《环太平洋》各国机甲】你觉得哪个国家的机甲最帅！？「转」	中国。必须是最好看的。
看来东北话准备占领世界了！	重庆话也是这个音调啊！